Rk,Player,Nation,Pos,Squad,Comp,Age,Born,90s,Tkl,TklW,Def 3rd,Mid 3rd,Att 3rd,Tkl.1,Att,Tkl%,Lost,Blocks,Sh,Pass,Int,Tkl+Int,Clr,Err,Matches
1,Max Aarons,eng ENG,DF,Bournemouth,eng Premier League,23,2000,13.7,29,19,20,7,2,20,34,58.8,14,9,5,4,8,37,27,0,Matches
2,Brenden Aaronson,us USA,"MF,FW",Union Berlin,de Bundesliga,22,2000,14.1,32,18,13,13,6,16,32,50.0,16,26,1,25,2,34,4,0,Matches
3,Paxten Aaronson,us USA,MF,Eint Frankfurt,de Bundesliga,19,2003,1.1,2,2,1,1,0,1,1,100.0,0,2,0,2,0,2,0,0,Matches
4,Keyliane Abdallah,fr FRA,FW,Marseille,fr Ligue 1,17,2006,0.0,0,0,0,0,0,0,0,,0,0,0,0,0,0,0,0,Matches
5,Yunis Abdelhamid,ma MAR,DF,Reims,fr Ligue 1,35,1987,30.9,64,35,36,23,5,26,45,57.8,19,51,32,19,39,103,109,2,Matches
6,Salis Abdul Samed,gh GHA,MF,Lens,fr Ligue 1,23,2000,16.9,21,14,8,10,3,8,18,44.4,10,12,1,11,12,33,18,0,Matches
7,Nabil Aberdin,fr FRA,DF,Getafe,es La Liga,20,2002,2.0,0,0,0,0,0,0,1,0.0,1,0,0,0,0,0,4,0,Matches
8,Laurent Abergel,fr FRA,MF,Lorient,fr Ligue 1,30,1993,31.8,85,52,43,34,8,38,96,39.6,58,29,6,23,61,146,61,3,Matches
9,Matthis Abline,fr FRA,FW,Nantes,fr Ligue 1,20,2003,11.6,9,4,4,3,2,3,8,37.5,5,3,0,3,3,12,5,0,Matches
10,Abner,br BRA,DF,Betis,es La Liga,23,2000,15.6,25,19,15,9,1,17,34,50.0,17,23,5,18,15,40,62,0,Matches
11,Zakaria Aboukhlal,ma MAR,"MF,FW",Toulouse,fr Ligue 1,23,2000,8.4,9,8,1,5,3,3,12,25.0,9,9,1,8,1,10,2,0,Matches
12,Abdel Abqar,ma MAR,DF,Alavés,es La Liga,24,1999,25.7,35,19,28,5,2,21,35,60.0,14,31,26,5,23,58,115,0,Matches
13,Tammy Abraham,eng ENG,FW,Roma,it Serie A,25,1997,2.7,3,1,0,1,2,0,0,,0,1,0,1,0,3,4,0,Matches
14,Francesco Acerbi,it ITA,DF,Inter,it Serie A,35,1988,26.5,22,13,16,6,0,11,14,78.6,3,20,13,7,32,54,77,1,Matches
15,Joshua Acheampong,eng ENG,DF,Chelsea,eng Premier League,17,2006,0.1,0,0,0,0,0,0,0,,0,3,3,0,0,0,0,0,Matches
16,Marcos Acuña,ar ARG,DF,Sevilla,es La Liga,31,1991,14.4,33,21,20,12,1,9,14,64.3,5,12,2,10,4,37,25,0,Matches
17,Akor Adams,ng NGA,FW,Montpellier,fr Ligue 1,23,2000,25.0,12,4,3,4,5,3,7,42.9,4,9,2,7,5,17,11,0,Matches
18,Tyler Adams,us USA,MF,Bournemouth,eng Premier League,24,1999,1.3,4,3,1,3,0,2,3,66.7,1,2,0,2,4,8,2,0,Matches
19,Junior Adamu,at AUT,"FW,MF",Freiburg,de Bundesliga,22,2001,1.2,5,1,1,2,2,1,2,50.0,1,1,0,1,0,5,2,0,Matches
20,Sargis Adamyan,am ARM,"FW,MF",Köln,de Bundesliga,30,1993,8.9,14,9,2,9,3,6,11,54.5,5,16,1,15,5,19,7,0,Matches
21,Tosin Adarabioyo,eng ENG,DF,Fulham,eng Premier League,25,1997,18.0,21,11,16,5,0,12,21,57.1,9,16,11,5,25,46,80,0,Matches
22,Elijah Adebayo,eng ENG,FW,Luton Town,eng Premier League,25,1998,15.8,4,1,1,0,3,1,12,8.3,11,13,2,11,6,10,25,0,Matches
23,Karim Adeyemi,de GER,"FW,MF",Dortmund,de Bundesliga,21,2002,10.1,16,14,9,4,3,8,20,40.0,12,11,0,11,3,19,5,0,Matches
24,Simon Adingra,ci CIV,FW,Brighton,eng Premier League,21,2002,24.7,45,20,23,11,11,19,42,45.2,23,31,1,30,19,64,22,0,Matches
25,Nathaniel Adjei,gh GHA,DF,Lorient,fr Ligue 1,20,2002,13.8,13,9,8,3,2,6,7,85.7,1,15,8,7,18,31,64,1,Matches
26,Amine Adli,ma MAR,"MF,FW",Leverkusen,de Bundesliga,23,2000,10.0,16,7,2,10,4,7,17,41.2,10,10,2,8,6,22,5,0,Matches
27,Yacine Adli,fr FRA,MF,Milan,it Serie A,23,2000,15.6,34,17,17,13,4,13,35,37.1,22,22,8,14,20,54,15,1,Matches
28,Adryelson,br BRA,"DF,FW",Lyon,fr Ligue 1,25,1998,0.1,0,0,0,0,0,0,0,,0,0,0,0,1,1,3,0,Matches
29,Adson,br BRA,"MF,FW",Nantes,fr Ligue 1,22,2000,2.6,7,6,1,6,0,2,2,100.0,0,5,0,5,2,9,2,0,Matches
30,Michel Aebischer,ch SUI,MF,Bologna,it Serie A,26,1997,24.8,35,20,9,20,6,15,34,44.1,19,28,6,22,12,47,22,0,Matches
31,Emmanuel Agbadou,ci CIV,DF,Reims,fr Ligue 1,26,1997,28.8,65,41,38,23,4,44,64,68.8,20,47,25,22,55,120,116,1,Matches
32,Julen Agirrezabala,es ESP,GK,Athletic Club,es La Liga,22,2000,2.6,0,0,0,0,0,0,0,,0,0,0,0,0,0,0,0,Matches
33,Lucien Agoume,fr FRA,MF,Inter,it Serie A,21,2002,0.1,0,0,0,0,0,0,0,,0,0,0,0,0,0,0,0,Matches
34,Lucien Agoume,fr FRA,MF,Sevilla,es La Liga,21,2002,8.6,23,18,7,14,2,9,12,75.0,3,6,1,5,7,30,8,0,Matches
35,Felix Agu,ng NGA,"DF,MF",Werder Bremen,de Bundesliga,23,1999,17.9,45,29,28,13,4,29,41,70.7,12,27,7,20,13,58,41,0,Matches
36,Nayef Aguerd,ma MAR,DF,West Ham,eng Premier League,27,1996,20.6,26,14,19,7,0,16,22,72.7,6,33,24,9,17,43,85,2,Matches
37,Ruben Aguilar,fr FRA,DF,Lens,fr Ligue 1,30,1993,21.4,53,31,27,23,3,27,45,60.0,18,35,5,30,26,79,46,0,Matches
38,Brandon Aguilera,cr CRC,FW,Nott'ham Forest,eng Premier League,20,2003,0.1,0,0,0,0,0,0,0,,0,0,0,0,0,0,0,0,Matches
39,Naouirou Ahamada,fr FRA,"MF,FW",Crystal Palace,eng Premier League,21,2002,3.9,13,9,5,6,2,8,17,47.1,9,3,0,3,2,15,4,0,Matches
40,Anel Ahmedhodžić,ba BIH,DF,Sheffield Utd,eng Premier League,24,1999,29.4,64,36,48,14,2,30,49,61.2,19,43,26,17,34,98,137,2,Matches
41,Joseph Aidoo,gh GHA,DF,Celta Vigo,es La Liga,27,1995,4.5,8,3,6,2,0,4,8,50.0,4,3,1,2,4,12,28,0,Matches
42,Ola Aina,ng NGA,DF,Nott'ham Forest,eng Premier League,26,1996,18.8,47,31,31,12,4,29,40,72.5,11,19,3,16,18,65,51,1,Matches
43,Rayan Aït-Nouri,dz ALG,"DF,MF",Wolves,eng Premier League,22,2001,25.9,71,44,41,23,7,28,49,57.1,21,32,6,26,15,86,38,0,Matches
44,Tosin Aiyegun,bj BEN,"MF,FW",Lorient,fr Ligue 1,25,1998,10.0,6,4,2,3,1,3,9,33.3,6,4,1,3,2,8,8,0,Matches
45,Kristoffer Ajer,no NOR,DF,Brentford,eng Premier League,25,1998,20.4,38,21,25,9,4,23,36,63.9,13,26,11,15,25,63,79,1,Matches
46,Ludovic Ajorque,fr FRA,FW,Mainz 05,de Bundesliga,29,1994,15.1,3,2,1,2,0,2,11,18.2,9,6,2,4,4,7,11,0,Matches
47,Manuel Akanji,ch SUI,"DF,MF",Manchester City,eng Premier League,28,1995,27.9,42,28,16,18,8,22,39,56.4,17,28,12,16,23,65,70,3,Matches
48,Marley Aké,fr FRA,FW,Udinese,it Serie A,22,2001,0.1,0,0,0,0,0,0,0,,0,0,0,0,0,0,0,0,Matches
49,Nathan Aké,nl NED,DF,Manchester City,eng Premier League,28,1995,22.7,26,16,15,8,3,13,20,65.0,7,17,2,15,14,40,54,0,Matches
50,Ilias Akhomach,ma MAR,"MF,FW",Villarreal,es La Liga,19,2004,16.8,36,21,11,16,9,10,20,50.0,10,10,2,8,13,49,13,0,Matches
51,Sergio Akieme,es ESP,DF,Almería,es La Liga,25,1997,18.6,27,15,18,7,2,13,16,81.3,3,14,4,10,10,37,34,0,Matches
52,Sergio Akieme,es ESP,DF,Reims,fr Ligue 1,25,1997,9.1,11,5,6,3,2,8,11,72.7,3,9,3,6,10,21,25,0,Matches
53,Ebenezer Akinsanmiro,ng NGA,MF,Inter,it Serie A,18,2004,0.2,0,0,0,0,0,0,1,0.0,1,0,0,0,0,0,0,0,Matches
54,Maghnes Akliouche,fr FRA,"MF,FW",Monaco,fr Ligue 1,21,2002,17.9,37,23,12,20,5,12,36,33.3,24,21,0,21,9,46,3,0,Matches
55,Paul Akouokou,ci CIV,MF,Betis,es La Liga,25,1997,0.3,5,3,0,2,3,3,3,100.0,0,3,1,2,1,6,1,0,Matches
56,Paul Akouokou,ci CIV,MF,Lyon,fr Ligue 1,25,1997,3.4,14,9,2,10,2,6,7,85.7,1,5,1,4,6,20,11,0,Matches
57,Jean-Daniel Akpa-Akpro,ci CIV,MF,Monza,it Serie A,30,1992,7.8,20,11,14,4,2,3,9,33.3,6,10,4,6,12,32,15,1,Matches
58,David Akpan Ankeye,ng NGA,FW,Genoa,it Serie A,21,2002,0.6,1,0,0,1,0,0,1,0.0,1,1,0,1,0,1,0,0,Matches
59,Kevin Akpoguma,ng NGA,DF,Hoffenheim,de Bundesliga,28,1995,12.2,35,18,22,12,1,26,35,74.3,9,28,8,20,18,53,32,0,Matches
60,David Alaba,at AUT,DF,Real Madrid,es La Liga,31,1992,12.8,13,9,7,5,1,4,8,50.0,4,10,7,3,15,28,34,0,Matches
61,Luis Alberto,es ESP,MF,Lazio,it Serie A,30,1992,25.7,35,20,16,12,7,15,53,28.3,38,34,4,30,7,42,13,0,Matches
62,Raúl Albiol,es ESP,DF,Villarreal,es La Liga,37,1985,22.6,25,14,15,9,1,18,27,66.7,9,31,24,7,16,41,102,0,Matches
63,Thiago Alcántara,es ESP,MF,Liverpool,eng Premier League,32,1991,0.1,0,0,0,0,0,0,0,,0,0,0,0,0,0,0,0,Matches
64,Carlos Alcaraz,ar ARG,MF,Juventus,it Serie A,20,2002,4.2,6,6,0,6,0,5,10,50.0,5,5,2,3,5,11,4,0,Matches
65,Rubén Alcaraz,es ESP,MF,Cádiz,es La Liga,32,1991,34.8,97,59,39,52,6,50,121,41.3,71,60,14,46,33,130,55,2,Matches
66,Omar Alderete,py PAR,DF,Getafe,es La Liga,26,1996,24.4,28,21,15,13,0,19,35,54.3,16,30,18,12,13,41,111,0,Matches
67,Iván Alejo,es ESP,MF,Cádiz,es La Liga,28,1995,18.8,40,23,23,11,6,17,57,29.8,40,20,0,20,7,47,17,0,Matches
68,Carles Aleñá,es ESP,MF,Getafe,es La Liga,25,1998,11.3,24,8,7,14,3,10,24,41.7,14,14,3,11,4,28,13,0,Matches
69,Trent Alexander-Arnold,eng ENG,DF,Liverpool,eng Premier League,24,1998,23.9,39,26,26,11,2,27,87,31.0,60,22,2,20,31,70,48,5,Matches
70,Aboubacar Ali,km COM,"MF,FW",Strasbourg,fr Ligue 1,17,2006,1.4,2,0,0,2,0,0,0,,0,1,0,1,1,3,2,0,Matches
71,Mohamed Ali Cho,fr FRA,"FW,MF",Real Sociedad,es La Liga,19,2004,2.8,4,3,3,1,0,2,7,28.6,5,6,0,6,1,5,1,0,Matches
72,Mohamed Ali Cho,fr FRA,FW,Nice,fr Ligue 1,19,2004,9.6,12,9,4,7,1,3,11,27.3,8,10,0,10,3,15,6,0,Matches
73,Faride Alidou,de GER,"FW,MF",Köln,de Bundesliga,22,2001,14.2,10,4,3,6,1,4,18,22.2,14,23,2,21,8,18,15,1,Matches
74,Nabil Alioui,fr FRA,"MF,FW",Le Havre,fr Ligue 1,24,1999,11.2,3,2,2,1,0,2,4,50.0,2,6,1,5,3,6,4,0,Matches
75,Alisson,br BRA,GK,Liverpool,eng Premier League,30,1992,28.0,0,0,0,0,0,0,1,0.0,1,0,0,0,0,0,11,4,Matches
76,Tadeo Allende,ar ARG,"MF,FW",Celta Vigo,es La Liga,24,1999,3.7,6,1,3,2,1,4,6,66.7,2,3,0,3,3,9,3,0,Matches
77,Jim Allevinah,ga GAB,"MF,DF",Clermont Foot,fr Ligue 1,28,1995,20.7,30,18,11,14,5,14,35,40.0,21,20,3,17,13,43,30,0,Matches
78,Domingos André Ribeiro Almeida,pt POR,"FW,MF",Valencia,es La Liga,23,2000,10.7,25,15,9,12,4,9,19,47.4,10,13,1,12,6,31,5,0,Matches
79,Miguel Almirón,py PAR,FW,Newcastle Utd,eng Premier League,29,1994,21.5,36,24,13,15,8,11,29,37.9,18,29,2,27,10,46,13,0,Matches
80,Pontus Almqvist,se SWE,"FW,MF",Lecce,it Serie A,24,1999,23.4,45,29,16,22,7,23,51,45.1,28,21,2,19,14,59,10,0,Matches
81,Marcos Alonso,es ESP,DF,Barcelona,es La Liga,32,1990,2.8,5,3,2,3,0,3,4,75.0,1,2,0,2,4,9,6,0,Matches
82,Adrià Altimira,es ESP,"DF,MF",Villarreal,es La Liga,22,2001,8.6,16,7,9,6,1,9,24,37.5,15,18,5,13,5,21,18,0,Matches
83,Sergi Altimira,es ESP,MF,Betis,es La Liga,21,2001,6.3,15,8,8,6,1,11,23,47.8,12,12,1,11,9,24,10,0,Matches
84,Edson Álvarez,mx MEX,MF,West Ham,eng Premier League,25,1997,26.4,80,39,47,26,7,31,66,47.0,35,59,20,39,42,122,81,0,Matches
85,Gastón Álvarez,uy URU,DF,Getafe,es La Liga,23,2000,28.2,68,37,43,20,5,37,57,64.9,20,40,11,29,35,103,80,0,Matches
86,Hugo Álvarez,es ESP,"MF,DF",Celta Vigo,es La Liga,20,2003,8.5,14,9,8,3,3,9,20,45.0,11,4,1,3,5,19,9,0,Matches
87,Julián Álvarez,ar ARG,"MF,FW",Manchester City,eng Premier League,23,2000,29.4,24,13,5,8,11,8,32,25.0,24,30,0,30,2,26,14,1,Matches
88,Yeray Álvarez,es ESP,DF,Athletic Club,es La Liga,28,1995,12.8,18,9,15,3,0,12,19,63.2,7,8,5,3,11,29,34,1,Matches
89,Skelly Alvero,fr FRA,MF,Lyon,fr Ligue 1,21,2002,4.7,8,7,5,2,1,2,9,22.2,7,5,1,4,2,10,5,0,Matches
90,Skelly Alvero,fr FRA,MF,Werder Bremen,de Bundesliga,21,2002,1.4,6,4,1,5,0,3,3,100.0,0,3,1,2,1,7,1,0,Matches
91,Papa Amadou Diallo,sn SEN,FW,Metz,fr Ligue 1,19,2004,9.9,18,8,10,7,1,7,21,33.3,14,11,1,10,11,29,16,0,Matches
92,Selim Amallah,ma MAR,"FW,MF",Valencia,es La Liga,26,1996,6.7,17,12,7,7,3,3,9,33.3,6,13,0,13,11,28,6,0,Matches
93,Amath,sn SEN,"FW,MF",Mallorca,es La Liga,27,1996,4.4,9,6,7,2,0,2,10,20.0,8,2,0,2,3,12,6,0,Matches
94,Lorenzo Amatucci,it ITA,MF,Fiorentina,it Serie A,19,2004,0.2,0,0,0,0,0,0,0,,0,0,0,0,0,0,0,0,Matches
95,Jordan Amavi,fr FRA,DF,Brest,fr Ligue 1,29,1994,1.0,1,1,0,1,0,1,3,33.3,2,2,1,1,3,4,2,0,Matches
96,Zeki Amdouni,ch SUI,FW,Burnley,eng Premier League,22,2000,21.7,27,18,1,15,11,7,25,28.0,18,23,10,13,9,36,10,0,Matches
97,Kelvin Amian,fr FRA,DF,Nantes,fr Ligue 1,25,1998,8.9,16,7,12,4,0,11,15,73.3,4,6,0,6,7,23,28,0,Matches
98,Bruno Amione,ar ARG,DF,Hellas Verona,it Serie A,21,2002,6.4,11,3,9,2,0,4,5,80.0,1,4,2,2,9,20,19,2,Matches
99,Michael Amir Murillo,pa PAN,DF,Marseille,fr Ligue 1,27,1996,11.1,23,11,13,6,4,15,23,65.2,8,9,2,7,11,34,34,2,Matches
100,Nadiem Amiri,de GER,MF,Mainz 05,de Bundesliga,26,1996,14.6,22,14,8,10,4,13,19,68.4,6,16,2,14,14,36,18,0,Matches
101,Nadiem Amiri,de GER,MF,Leverkusen,de Bundesliga,26,1996,1.0,4,2,0,3,1,0,3,0.0,3,0,0,0,0,4,1,0,Matches
102,Kofi Amoako,de GER,MF,Wolfsburg,de Bundesliga,18,2005,0.0,0,0,0,0,0,0,0,,0,0,0,0,0,0,0,0,Matches
103,Sofyan Amrabat,ma MAR,"MF,DF",Manchester Utd,eng Premier League,26,1996,10.4,27,16,17,8,2,17,31,54.8,14,20,7,13,8,35,19,2,Matches
104,Joachim Andersen,dk DEN,DF,Crystal Palace,eng Premier League,27,1996,37.9,56,35,33,21,2,29,39,74.4,10,33,18,15,41,97,207,1,Matches
105,Elliot Anderson,eng ENG,"MF,FW",Newcastle Utd,eng Premier League,20,2002,11.4,24,18,12,9,3,15,29,51.7,14,23,4,19,8,32,23,0,Matches
106,Felipe Anderson,br BRA,"FW,MF",Lazio,it Serie A,30,1993,30.8,78,45,32,33,13,34,90,37.8,56,45,3,42,27,105,23,0,Matches
107,Benjamin André,fr FRA,MF,Lille,fr Ligue 1,32,1990,28.6,89,49,39,45,5,43,81,53.1,38,34,5,29,35,124,60,0,Matches
108,Komnen Andrić,rs SRB,FW,Clermont Foot,fr Ligue 1,28,1995,1.9,2,1,0,1,1,0,4,0.0,4,2,0,2,0,2,1,0,Matches
109,Robert Andrich,de GER,"MF,DF",Leverkusen,de Bundesliga,28,1994,18.8,30,18,8,14,8,13,24,54.2,11,15,4,11,20,50,17,0,Matches
110,Miguel Ángel Rubio,es ESP,DF,Granada,es La Liga,25,1998,17.3,20,12,14,6,0,14,21,66.7,7,31,18,13,28,48,74,2,Matches
111,Angeliño,es ESP,DF,Roma,it Serie A,26,1997,12.7,21,11,12,6,3,11,19,57.9,8,11,5,6,12,33,37,1,Matches
112,Ângelo,br BRA,"FW,MF",Strasbourg,fr Ligue 1,18,2004,12.2,24,11,9,7,8,11,31,35.5,20,18,0,18,9,33,2,0,Matches
113,Fabrizio Angileri,ar ARG,"DF,MF",Getafe,es La Liga,29,1994,1.8,1,1,1,0,0,1,3,33.3,2,0,0,0,4,5,8,0,Matches
114,Jaidon Anthony,eng ENG,FW,Bournemouth,eng Premier League,23,1999,1.7,3,1,1,0,2,1,7,14.3,6,3,0,3,1,4,3,0,Matches
115,Waldemar Anton,de GER,DF,Stuttgart,de Bundesliga,27,1996,32.1,39,25,21,16,2,23,42,54.8,19,33,20,13,40,79,150,1,Matches
116,Michail Antonio,jm JAM,FW,West Ham,eng Premier League,33,1990,18.8,15,8,5,6,4,3,11,27.3,8,16,3,13,4,19,4,0,Matches
117,Antony,br BRA,FW,Manchester Utd,eng Premier League,23,2000,14.7,40,21,15,19,6,20,40,50.0,20,29,1,28,12,52,9,0,Matches
118,Christopher Antwi-Adjei,gh GHA,"FW,MF",Bochum,de Bundesliga,29,1994,13.5,21,12,10,6,5,12,22,54.5,10,13,2,11,2,23,11,1,Matches
119,Houssem Aouar,dz ALG,"MF,FW",Roma,it Serie A,25,1998,8.4,16,11,4,10,2,3,12,25.0,9,5,0,5,4,20,2,1,Matches
120,Stredair Appuah,fr FRA,"FW,MF",Nantes,fr Ligue 1,19,2004,0.9,0,0,0,0,0,0,3,0.0,3,0,0,0,1,1,1,0,Matches
121,Mauro Arambarri,uy URU,MF,Getafe,es La Liga,27,1995,3.8,6,2,3,2,1,1,6,16.7,5,1,0,1,2,8,7,0,Matches
122,Jon Aramburu,ve VEN,DF,Real Sociedad,es La Liga,21,2002,6.0,24,15,12,10,2,15,25,60.0,10,8,3,5,7,31,17,0,Matches
123,Asaf Arania,il ISR,MF,Darmstadt 98,de Bundesliga,17,2005,0.1,0,0,0,0,0,0,0,,0,0,0,0,0,0,0,0,Matches
124,Julian Araujo,mx MEX,DF,Las Palmas,es La Liga,21,2001,16.2,41,22,29,7,5,23,33,69.7,10,23,16,7,10,51,52,1,Matches
125,Ronald Araújo,uy URU,DF,Barcelona,es La Liga,24,1999,22.2,27,22,11,15,1,12,17,70.6,5,20,11,9,12,39,66,2,Matches
126,Oliver Arblaster,eng ENG,MF,Sheffield Utd,eng Premier League,19,2004,10.5,23,14,11,8,4,7,15,46.7,8,17,7,10,16,39,9,0,Matches
127,Cameron Archer,eng ENG,"FW,MF",Sheffield Utd,eng Premier League,22,2001,20.4,18,13,6,6,6,8,18,44.4,10,22,3,19,1,19,11,0,Matches
128,Cameron Archer,eng ENG,MF,Aston Villa,eng Premier League,22,2001,0.1,0,0,0,0,0,0,0,,0,0,0,0,0,0,0,0,Matches
129,Alphonse Areola,fr FRA,GK,West Ham,eng Premier League,30,1993,30.0,1,1,1,0,0,1,3,33.3,2,0,0,0,1,2,16,0,Matches
130,Adu Ares,es ESP,FW,Athletic Club,es La Liga,21,2001,2.9,8,4,4,2,2,2,3,66.7,1,1,0,1,1,9,0,0,Matches
131,Jesús Areso,es ESP,DF,Osasuna,es La Liga,24,1999,29.6,45,24,25,13,7,31,38,81.6,7,36,15,21,18,63,58,0,Matches
132,Simone Aresti,it ITA,GK,Cagliari,it Serie A,37,1986,0.0,0,0,0,0,0,0,0,,0,0,0,0,0,0,0,0,Matches
133,Matias Arezo,uy URU,FW,Granada,es La Liga,20,2002,4.1,7,3,2,5,0,1,5,20.0,4,4,1,3,1,8,4,0,Matches
134,Iñigo Arguibide,es ESP,DF,Osasuna,es La Liga,18,2005,0.2,1,0,0,1,0,0,0,,0,0,0,0,0,1,1,0,Matches
135,Yoël Armougom,fr FRA,"DF,MF",Clermont Foot,fr Ligue 1,25,1998,2.6,3,3,2,0,1,2,3,66.7,1,1,0,1,1,4,3,0,Matches
136,José Arnaiz,es ESP,"FW,MF",Osasuna,es La Liga,28,1995,10.3,14,8,6,4,4,6,21,28.6,15,11,2,9,3,17,2,0,Matches
137,Hákon Arnar Haraldsson,is ISL,"FW,MF",Lille,fr Ligue 1,20,2003,14.3,12,8,4,7,1,5,21,23.8,16,7,2,5,3,15,5,0,Matches
138,Marko Arnautović,at AUT,FW,Inter,it Serie A,34,1989,8.9,10,4,3,5,2,4,7,57.1,3,8,1,7,5,15,5,0,Matches
139,Maximilian Arnold,de GER,MF,Wolfsburg,de Bundesliga,29,1994,27.8,51,31,15,27,9,28,57,49.1,29,23,4,19,24,75,60,0,Matches
140,Mohamed El Arouch,fr FRA,FW,Lyon,fr Ligue 1,19,2004,0.0,0,0,0,0,0,0,0,,0,0,0,0,0,0,0,0,Matches
141,Sergio Arribas,es ESP,"MF,FW",Almería,es La Liga,21,2001,22.7,34,17,16,17,1,14,31,45.2,17,20,1,19,16,50,8,1,Matches
142,Kepa Arrizabalaga,es ESP,GK,Real Madrid,es La Liga,28,1994,13.3,0,0,0,0,0,0,1,0.0,1,0,0,0,0,0,4,0,Matches
143,Arthur,br BRA,DF,Leverkusen,de Bundesliga,20,2003,2.0,4,3,2,0,2,2,2,100.0,0,1,1,0,0,4,7,0,Matches
144,Takuma Asano,jp JPN,"FW,MF",Bochum,de Bundesliga,28,1994,22.1,17,6,2,9,6,7,23,30.4,16,17,3,14,4,21,11,0,Matches
145,Marco Asensio,es ESP,"MF,FW",Paris S-G,fr Ligue 1,27,1996,12.4,12,10,4,7,1,4,13,30.8,9,7,0,7,5,17,2,0,Matches
146,Kristjan Asllani,al ALB,MF,Inter,it Serie A,21,2002,8.7,7,2,3,4,0,2,11,18.2,9,9,3,6,11,18,8,0,Matches
147,Joel Asoro,se SWE,"FW,MF",Metz,fr Ligue 1,24,1999,9.4,13,9,7,6,0,3,10,30.0,7,7,1,6,6,19,9,0,Matches
148,Jonathan Asp Jensen,dk DEN,FW,Bayern Munich,de Bundesliga,17,2006,0.0,0,0,0,0,0,0,0,,0,0,0,0,0,0,1,0,Matches
149,Iago Aspas,es ESP,FW,Celta Vigo,es La Liga,35,1987,30.1,11,6,4,6,1,1,15,6.7,14,23,3,20,10,21,8,0,Matches
150,Lorenz Assignon,tg TOG,DF,Burnley,eng Premier League,23,2000,13.7,35,17,18,13,4,14,27,51.9,13,22,7,15,19,54,43,1,Matches
151,Lorenz Assignon,tg TOG,DF,Rennes,fr Ligue 1,23,2000,11.2,24,12,12,8,4,9,24,37.5,15,9,4,5,9,33,27,1,Matches
152,Youcef Atal,dz ALG,DF,Nice,fr Ligue 1,27,1996,4.0,9,3,6,2,1,6,8,75.0,2,7,1,6,4,13,1,0,Matches
153,Valentin Atangana Edoa,fr FRA,MF,Reims,fr Ligue 1,17,2005,6.2,19,13,6,9,4,5,13,38.5,8,5,1,4,6,25,9,0,Matches
154,Arthur Atta,fr FRA,"MF,FW",Metz,fr Ligue 1,20,2003,10.3,18,14,8,7,3,8,19,42.1,11,13,3,10,10,28,23,0,Matches
155,Noah Atubolu,de GER,GK,Freiburg,de Bundesliga,21,2002,34.0,0,0,0,0,0,0,1,0.0,1,0,0,0,0,0,8,1,Matches
156,Pierre-Emerick Aubameyang,ga GAB,FW,Marseille,fr Ligue 1,34,1989,29.1,22,14,4,11,7,7,26,26.9,19,30,5,25,9,31,26,0,Matches
157,Emil Audero,id IDN,GK,Inter,it Serie A,26,1997,3.7,0,0,0,0,0,0,0,,0,0,0,0,0,0,1,0,Matches
158,Tommaso Augello,it ITA,DF,Cagliari,it Serie A,28,1994,26.9,26,19,18,6,2,16,25,64.0,9,21,10,11,17,43,89,0,Matches
159,Carlos Augusto,br BRA,DF,Inter,it Serie A,24,1999,19.2,29,21,20,9,0,15,22,68.2,7,20,8,12,16,45,52,0,Matches
160,Yann Aurel Bisseck,de GER,DF,Inter,it Serie A,22,2000,10.0,14,6,10,3,1,6,9,66.7,3,10,7,3,5,19,23,0,Matches
161,Serge Aurier,ci CIV,"DF,MF",Nott'ham Forest,eng Premier League,30,1992,9.3,20,14,9,11,0,5,11,45.5,6,10,3,7,9,29,36,1,Matches
162,Ezequiel Ávila,ar ARG,"FW,MF",Osasuna,es La Liga,29,1994,9.6,3,2,1,1,1,3,11,27.3,8,14,0,14,4,7,8,0,Matches
163,Ezequiel Ávila,ar ARG,FW,Betis,es La Liga,29,1994,3.3,2,1,0,2,0,1,3,33.3,2,2,0,2,1,3,4,0,Matches
164,Taiwo Awoniyi,ng NGA,FW,Nott'ham Forest,eng Premier League,25,1997,11.6,9,7,1,4,4,1,2,50.0,1,7,2,5,1,10,9,0,Matches
165,André Ayew,gh GHA,FW,Le Havre,fr Ligue 1,33,1989,12.3,15,11,7,6,2,6,9,66.7,3,8,3,5,2,17,11,0,Matches
166,Jordan Ayew,gh GHA,"FW,MF",Crystal Palace,eng Premier League,31,1991,28.3,65,36,23,28,14,21,42,50.0,21,43,2,41,16,81,15,0,Matches
167,Neil El Aynaoui,ma MAR,MF,Lens,fr Ligue 1,22,2001,17.4,37,20,13,20,4,20,46,43.5,26,20,6,14,32,69,21,1,Matches
168,Sardar Azmoun,ir IRN,"FW,MF",Roma,it Serie A,28,1995,6.5,8,5,2,5,1,4,8,50.0,4,4,1,3,3,11,6,1,Matches
169,César Azpilicueta,es ESP,DF,Atlético Madrid,es La Liga,33,1989,15.8,25,14,15,9,1,12,19,63.2,7,25,6,19,16,41,46,0,Matches
170,Paulo Azzi,br BRA,"DF,MF",Cagliari,it Serie A,29,1994,10.6,19,11,10,6,3,9,18,50.0,9,11,2,9,16,35,23,0,Matches
171,Oussama El Azzouzi,ma MAR,MF,Bologna,it Serie A,22,2001,6.1,12,7,4,5,3,7,14,50.0,7,8,2,6,6,18,12,0,Matches
172,Abdellah Baallal,ma MAR,MF,Clermont Foot,fr Ligue 1,18,2004,0.0,0,0,0,0,0,0,0,,0,1,0,1,0,0,0,0,Matches
173,Iddrisu Baba,gh GHA,MF,Almería,es La Liga,27,1996,15.9,46,26,27,18,1,17,39,43.6,22,20,6,14,11,57,27,2,Matches
174,Srđan Babić,rs SRB,DF,Almería,es La Liga,27,1996,1.0,2,2,0,2,0,1,1,100.0,0,1,1,0,0,2,2,0,Matches
175,Shavy Babicka,ga GAB,"FW,MF",Toulouse,fr Ligue 1,23,2000,4.1,11,8,2,7,2,2,5,40.0,3,6,1,5,0,11,2,0,Matches
176,Aliou Badara Baldé,gn GUI,"FW,DF",Nice,fr Ligue 1,20,2002,0.8,4,1,0,3,1,1,1,100.0,0,2,1,1,3,7,0,0,Matches
177,Loïc Bade,fr FRA,DF,Sevilla,es La Liga,23,2000,25.3,65,41,53,12,0,30,49,61.2,19,23,15,8,38,103,116,2,Matches
178,Milan Badelj,hr CRO,MF,Genoa,it Serie A,34,1989,28.2,51,27,23,24,4,24,61,39.3,37,45,13,32,50,101,54,1,Matches
179,Matthias Bader,de GER,"DF,MF",Darmstadt 98,de Bundesliga,26,1997,20.0,51,25,32,11,8,33,65,50.8,32,22,4,18,25,76,20,0,Matches
180,Benoît Badiashile,fr FRA,DF,Chelsea,eng Premier League,22,2001,14.9,21,15,12,9,0,9,14,64.3,5,21,14,7,18,39,66,2,Matches
181,Alex Baena,es ESP,"MF,FW",Villarreal,es La Liga,22,2001,28.7,34,21,10,16,8,20,47,42.6,27,23,2,21,13,47,17,1,Matches
182,Jaime Báez,uy URU,"FW,MF",Frosinone,it Serie A,28,1995,5.6,4,1,0,2,2,0,7,0.0,7,5,0,5,4,8,1,0,Matches
183,Nicola Bagnolini,it ITA,GK,Bologna,it Serie A,19,2004,0.1,0,0,0,0,0,0,0,,0,0,0,0,0,0,0,0,Matches
184,Leon Bailey,jm JAM,"MF,FW",Aston Villa,eng Premier League,25,1997,23.0,13,7,7,4,2,5,20,25.0,15,18,1,17,9,22,6,0,Matches
185,Eric Bailly,ci CIV,DF,Villarreal,es La Liga,29,1994,9.3,5,3,4,1,0,2,2,100.0,0,8,8,0,9,14,38,2,Matches
186,Stefan Bajcetic,es ESP,MF,Liverpool,eng Premier League,18,2004,0.3,4,1,3,1,0,3,5,60.0,2,0,0,0,0,4,0,0,Matches
187,Nedim Bajrami,al ALB,"MF,FW",Sassuolo,it Serie A,24,1999,14.6,13,6,6,3,4,5,13,38.5,8,5,1,4,6,19,8,0,Matches
188,Cédric Bakambu,cd COD,FW,Betis,es La Liga,32,1991,2.2,1,0,0,1,0,0,0,,0,2,0,2,0,1,0,0,Matches
189,Tiemoué Bakayoko,fr FRA,MF,Lorient,fr Ligue 1,28,1994,14.6,34,17,14,17,3,15,28,53.6,13,10,4,6,26,60,15,1,Matches
190,Mitchel Bakker,nl NED,DF,Atalanta,it Serie A,23,2000,4.2,7,3,6,1,0,2,12,16.7,10,5,0,5,3,10,6,0,Matches
191,Ridle Baku,de GER,"DF,MF",Wolfsburg,de Bundesliga,25,1998,22.4,37,20,24,7,6,21,46,45.7,25,27,1,26,21,58,45,1,Matches
192,Dilane Bakwa,fr FRA,"FW,MF",Strasbourg,fr Ligue 1,20,2002,24.2,30,22,12,13,5,11,40,27.5,29,26,1,25,20,50,11,0,Matches
193,Tommaso Baldanzi,it ITA,"MF,FW",Empoli,it Serie A,20,2003,8.3,4,2,1,1,2,3,10,30.0,7,7,0,7,2,6,0,0,Matches
194,Tommaso Baldanzi,it ITA,"FW,MF",Roma,it Serie A,20,2003,5.8,9,5,3,4,2,1,1,100.0,0,2,0,2,0,9,4,0,Matches
195,Alejandro Balde,es ESP,DF,Barcelona,es La Liga,19,2003,15.3,20,11,11,6,3,7,11,63.6,4,14,1,13,5,25,21,1,Matches
196,George Baldock,gr GRE,DF,Sheffield Utd,eng Premier League,30,1993,10.8,18,10,10,7,1,6,15,40.0,9,14,8,6,10,28,33,0,Matches
197,Carlos Baleba,cm CMR,MF,Brighton,eng Premier League,19,2004,14.7,40,20,17,19,4,23,46,50.0,23,35,7,28,18,58,30,3,Matches
198,Carlos Baleba,cm CMR,MF,Lille,fr Ligue 1,19,2004,0.7,6,2,1,4,1,3,4,75.0,1,0,0,0,2,8,0,0,Matches
199,Leonardo Balerdi,ar ARG,DF,Marseille,fr Ligue 1,24,1999,25.2,79,50,55,23,1,49,67,73.1,18,38,15,23,51,130,91,0,Matches
200,Iván Balliu,al ALB,DF,Rayo Vallecano,es La Liga,31,1992,31.9,44,31,20,24,0,22,39,56.4,17,27,11,16,29,73,66,1,Matches
201,Fodé Ballo-Touré,sn SEN,"DF,MF",Fulham,eng Premier League,26,1997,0.8,4,2,1,3,0,1,2,50.0,1,1,0,1,3,7,2,0,Matches
202,Folarin Balogun,us USA,FW,Monaco,fr Ligue 1,22,2001,18.8,12,4,3,8,1,5,13,38.5,8,10,0,10,3,15,4,0,Matches
203,Jonathan Bamba,ci CIV,"MF,FW",Celta Vigo,es La Liga,27,1996,22.0,14,9,4,8,2,2,17,11.8,15,20,0,20,18,32,12,0,Matches
204,Mohamed Bamba,ci CIV,FW,Lorient,fr Ligue 1,21,2001,12.6,14,9,3,8,3,4,10,40.0,6,7,1,6,2,16,3,0,Matches
205,Samuel Bamba,de GER,FW,Dortmund,de Bundesliga,19,2004,0.5,1,1,1,0,0,1,2,50.0,1,0,0,0,0,1,1,0,Matches
206,Lameck Banda,zm ZAM,FW,Lecce,it Serie A,22,2001,15.0,27,23,11,12,4,7,21,33.3,14,18,0,18,3,30,7,0,Matches
207,Daniel Bandeira,pt POR,MF,Hellas Verona,it Serie A,23,2000,5.0,6,5,1,4,1,3,7,42.9,4,3,0,3,3,9,9,0,Matches
208,Mamady Bangré,bf BFA,"FW,MF",Toulouse,fr Ligue 1,22,2001,1.1,4,2,2,2,0,3,4,75.0,1,0,0,0,4,8,3,0,Matches
209,Mattia Bani,it ITA,DF,Genoa,it Serie A,29,1993,25.6,26,10,18,7,1,11,22,50.0,11,51,31,20,22,48,116,1,Matches
210,Léo Baptistão,br BRA,FW,Almería,es La Liga,30,1992,20.4,25,16,12,8,5,9,25,36.0,16,13,1,12,11,36,22,0,Matches
211,Shandon Baptiste,gd GRN,MF,Brentford,eng Premier League,25,1998,2.5,4,4,2,2,0,1,5,20.0,4,5,1,4,3,7,6,0,Matches
212,Antonín Barák,cz CZE,"MF,FW",Fiorentina,it Serie A,28,1994,9.0,6,2,1,3,2,3,7,42.9,4,5,0,5,2,8,4,0,Matches
213,Valentín Barco,ar ARG,"DF,FW",Brighton,eng Premier League,19,2004,3.4,11,5,4,5,2,6,8,75.0,2,3,0,3,4,15,3,1,Matches
214,Bradley Barcola,fr FRA,FW,Lyon,fr Ligue 1,20,2002,3.0,5,2,0,2,3,1,7,14.3,6,4,0,4,2,7,0,0,Matches
215,Bradley Barcola,fr FRA,"FW,MF",Paris S-G,fr Ligue 1,20,2002,15.2,34,16,12,13,9,7,25,28.0,18,27,2,25,10,44,13,1,Matches
216,Melvin Bard,fr FRA,DF,Nice,fr Ligue 1,22,2000,29.5,69,38,28,30,11,37,63,58.7,26,46,12,34,42,111,46,0,Matches
217,Nicolò Barella,it ITA,MF,Inter,it Serie A,26,1997,31.6,46,30,17,20,9,19,63,30.2,44,31,1,30,10,56,12,1,Matches
218,Kike Barja,es ESP,"FW,MF",Osasuna,es La Liga,26,1997,3.4,6,2,2,2,2,3,8,37.5,5,2,1,1,2,8,2,0,Matches
219,Ross Barkley,eng ENG,MF,Luton Town,eng Premier League,29,1993,29.1,47,19,16,21,10,11,48,22.9,37,25,9,16,25,72,51,2,Matches
220,Aymen Barkok,ma MAR,"MF,FW",Mainz 05,de Bundesliga,25,1998,3.6,9,5,2,6,1,3,6,50.0,3,7,0,7,2,11,1,0,Matches
221,Harvey Barnes,eng ENG,"FW,MF",Newcastle Utd,eng Premier League,25,1997,8.9,6,1,3,2,1,1,2,50.0,1,1,0,1,5,11,3,0,Matches
222,Leandro Barreiro Martins,lu LUX,MF,Mainz 05,de Bundesliga,23,2000,29.0,65,40,19,37,9,30,50,60.0,20,45,16,29,36,101,53,0,Matches
223,Enzo Barrenechea,ar ARG,MF,Frosinone,it Serie A,22,2001,31.2,65,42,28,29,8,28,70,40.0,42,47,12,35,27,92,61,2,Matches
224,Ander Barrenetxea,es ESP,"FW,MF",Real Sociedad,es La Liga,21,2001,15.9,32,21,7,16,9,10,26,38.5,16,18,1,17,6,38,5,0,Matches
225,Pablo Barrios,es ESP,MF,Atlético Madrid,es La Liga,20,2003,17.3,45,25,15,29,1,19,40,47.5,21,20,3,17,28,73,24,2,Matches
226,Davide Bartesaghi,it ITA,"DF,MF",Milan,it Serie A,17,2005,0.9,2,0,1,1,0,2,4,50.0,2,1,1,0,0,2,7,0,Matches
227,Marc Bartra,es ESP,DF,Betis,es La Liga,32,1991,2.5,4,3,3,1,0,4,5,80.0,1,3,1,2,3,7,10,0,Matches
228,Federico Baschirotto,it ITA,DF,Lecce,it Serie A,26,1996,36.6,21,12,16,5,0,8,15,53.3,7,42,26,16,23,44,144,1,Matches
229,Steven Baseya,fr FRA,DF,Strasbourg,fr Ligue 1,18,2005,0.1,2,1,1,1,0,1,1,100.0,0,0,0,0,0,2,1,0,Matches
230,Chris Basham,eng ENG,"DF,MF",Sheffield Utd,eng Premier League,35,1988,3.6,7,2,4,3,0,2,9,22.2,7,9,4,5,5,12,17,0,Matches
231,Toma Bašić,hr CRO,MF,Salernitana,it Serie A,26,1996,12.9,20,13,10,9,1,10,27,37.0,17,18,6,12,14,34,29,0,Matches
232,Calvin Bassey,ng NGA,DF,Fulham,eng Premier League,23,1999,25.6,49,29,33,15,1,21,29,72.4,8,32,11,21,28,77,84,4,Matches
233,Alessandro Bastoni,it ITA,DF,Inter,it Serie A,24,1999,25.2,46,33,31,12,3,26,40,65.0,14,25,11,14,23,69,48,1,Matches
234,Simone Bastoni,it ITA,"MF,DF",Empoli,it Serie A,26,1996,8.3,22,13,12,7,3,11,22,50.0,11,8,0,8,11,33,18,0,Matches
235,Augusto Batalla,ar ARG,GK,Granada,es La Liga,27,1996,17.0,0,0,0,0,0,0,1,0.0,1,0,0,0,0,0,10,2,Matches
236,Daniel Batz,de GER,GK,Mainz 05,de Bundesliga,32,1991,4.0,0,0,0,0,0,0,0,,0,0,0,0,0,0,3,0,Matches
237,Maximilian Bauer,de GER,DF,Augsburg,de Bundesliga,23,2000,9.0,19,12,13,4,2,9,17,52.9,8,14,8,6,11,30,30,1,Matches
238,Elias Baum,de GER,"DF,MF",Eint Frankfurt,de Bundesliga,17,2005,0.3,1,0,0,0,1,0,0,,0,3,2,1,0,1,1,0,Matches
239,Oliver Baumann,de GER,GK,Hoffenheim,de Bundesliga,33,1990,34.0,1,1,1,0,0,1,2,50.0,1,0,0,0,0,1,19,2,Matches
240,Christoph Baumgartner,at AUT,"MF,FW",RB Leipzig,de Bundesliga,23,1999,12.9,26,13,10,12,4,14,38,36.8,24,20,1,19,5,31,14,0,Matches
241,Bebé,cv CPV,"MF,FW",Rayo Vallecano,es La Liga,33,1990,2.4,2,2,1,1,0,1,5,20.0,4,1,0,1,0,2,0,0,Matches
242,Ihlas Bebou,tg TOG,"FW,DF",Hoffenheim,de Bundesliga,29,1994,18.2,22,12,10,8,4,8,16,50.0,8,13,2,11,14,36,15,0,Matches
243,Mohamed Bechikh,fr FRA,"FW,MF",Strasbourg,fr Ligue 1,18,2005,0.2,0,0,0,0,0,0,0,,0,0,0,0,0,0,0,0,Matches
244,Adrian Beck,de GER,"MF,FW",Heidenheim,de Bundesliga,26,1997,10.8,22,13,8,12,2,9,24,37.5,15,17,0,17,4,26,15,0,Matches
245,Owen Beck,wls WAL,DF,Liverpool,eng Premier League,20,2002,0.1,2,1,1,1,0,0,0,,0,0,0,0,0,2,1,0,Matches
246,Sheraldo Becker,sr SUR,"FW,MF",Real Sociedad,es La Liga,28,1995,8.6,2,2,0,2,0,0,1,0.0,1,3,0,3,1,3,0,0,Matches
247,Sheraldo Becker,sr SUR,"FW,MF",Union Berlin,de Bundesliga,28,1995,7.2,3,3,0,2,1,0,2,0.0,2,2,0,2,0,3,2,0,Matches
248,Chris Bedia,ci CIV,"FW,MF",Union Berlin,de Bundesliga,27,1996,1.6,2,1,0,2,0,0,1,0.0,1,3,0,3,0,2,2,0,Matches
249,Donny van de Beek,nl NED,DF,Manchester Utd,eng Premier League,26,1997,0.0,0,0,0,0,0,0,0,,0,1,0,1,0,0,0,0,Matches
250,Donny van de Beek,nl NED,"MF,FW",Eint Frankfurt,de Bundesliga,26,1997,4.0,8,3,3,3,2,3,7,42.9,4,5,1,4,3,11,1,0,Matches
251,Yanis Begraoui,ma MAR,"FW,MF",Toulouse,fr Ligue 1,22,2001,3.3,5,3,1,3,1,3,9,33.3,6,4,0,4,5,10,5,0,Matches
252,Kevin Behrens,de GER,FW,Wolfsburg,de Bundesliga,32,1991,6.8,2,1,0,1,1,0,2,0.0,2,9,0,9,3,5,6,0,Matches
253,Kevin Behrens,de GER,FW,Union Berlin,de Bundesliga,32,1991,14.0,13,10,3,7,3,1,4,25.0,3,7,2,5,6,19,19,0,Matches
254,Maximilian Beier,de GER,"FW,MF",Hoffenheim,de Bundesliga,20,2002,26.9,20,12,5,11,4,4,19,21.1,15,21,1,20,9,29,12,0,Matches
255,Jérémie Bela,ao ANG,"MF,FW",Clermont Foot,fr Ligue 1,30,1993,2.3,1,1,0,1,0,1,3,33.3,2,1,0,1,0,1,1,0,Matches
256,Reda Belahyane,ma MAR,MF,Hellas Verona,it Serie A,19,2004,1.0,1,1,0,1,0,1,1,100.0,0,0,0,0,1,2,0,0,Matches
257,Reda Belahyane,ma MAR,MF,Nice,fr Ligue 1,19,2004,0.3,1,0,0,1,0,1,1,100.0,0,0,0,0,0,1,0,0,Matches
258,Amari'i Bell,jm JAM,DF,Luton Town,eng Premier League,29,1994,19.1,50,33,30,19,1,22,35,62.9,13,33,15,18,25,75,60,1,Matches
259,Stefan Bell,de GER,DF,Mainz 05,de Bundesliga,31,1991,7.4,8,8,7,1,0,4,8,50.0,4,7,5,2,6,14,30,0,Matches
260,Alaa Bellaarouch,ma MAR,GK,Strasbourg,fr Ligue 1,21,2002,15.0,0,0,0,0,0,0,0,,0,0,0,0,1,1,11,2,Matches
261,Raoul Bellanova,it ITA,DF,Torino,it Serie A,23,2000,33.8,36,26,15,17,4,18,31,58.1,13,21,4,17,15,51,36,3,Matches
262,Jean-Ricner Bellegarde,ht HAI,"MF,FW",Wolves,eng Premier League,25,1998,10.6,17,10,9,6,2,7,15,46.7,8,18,2,16,8,25,14,0,Matches
263,Jean-Ricner Bellegarde,ht HAI,"MF,FW",Strasbourg,fr Ligue 1,25,1998,3.0,5,3,3,2,0,3,6,50.0,3,4,0,4,4,9,0,0,Matches
264,Héctor Bellerín,es ESP,DF,Betis,es La Liga,28,1995,19.0,34,22,14,16,4,20,53,37.7,33,13,5,8,22,56,40,1,Matches
265,Jude Bellingham,eng ENG,MF,Real Madrid,es La Liga,20,2003,25.7,42,34,14,18,10,12,36,33.3,24,55,5,50,21,63,17,0,Matches
266,Jeanuël Belocian,fr FRA,DF,Rennes,fr Ligue 1,18,2005,16.1,32,22,23,8,1,22,28,78.6,6,18,10,8,13,45,49,0,Matches
267,Andrea Belotti,it ITA,FW,Fiorentina,it Serie A,29,1993,10.5,8,3,1,5,2,5,12,41.7,7,8,1,7,2,10,3,0,Matches
268,Andrea Belotti,it ITA,FW,Roma,it Serie A,29,1993,7.5,8,4,2,3,3,3,6,50.0,3,7,0,7,2,10,3,0,Matches
269,Fran Beltrán,es ESP,MF,Celta Vigo,es La Liga,24,1999,27.0,56,32,22,23,11,24,63,38.1,39,28,2,26,18,74,34,0,Matches
270,Lucas Beltrán,ar ARG,"FW,MF",Fiorentina,it Serie A,22,2001,18.8,27,14,4,18,5,11,20,55.0,9,29,3,26,2,29,11,0,Matches
271,Eliesse Ben Seghir,ma MAR,"MF,FW",Monaco,fr Ligue 1,18,2005,4.8,9,6,2,5,2,3,7,42.9,4,6,0,6,2,11,2,0,Matches
272,Anis Ben Slimane,tn TUN,MF,Sheffield Utd,eng Premier League,22,2001,4.7,11,6,5,2,4,4,10,40.0,6,7,1,6,5,16,7,0,Matches
273,Wissam Ben Yedder,fr FRA,FW,Monaco,fr Ligue 1,32,1990,25.7,4,3,1,2,1,1,11,9.1,10,18,0,18,8,12,1,0,Matches
274,Carlos Benavídez,uy URU,MF,Alavés,es La Liga,25,1998,12.6,56,35,19,26,11,19,34,55.9,15,13,5,8,19,75,31,0,Matches
275,Ismaël Bennacer,dz ALG,MF,Milan,it Serie A,25,1997,12.8,29,19,11,16,2,11,22,50.0,11,12,4,8,12,41,9,2,Matches
276,Saïd Benrahma,dz ALG,"FW,MF",West Ham,eng Premier League,27,1995,6.9,8,4,5,3,0,4,15,26.7,11,8,0,8,5,13,7,0,Matches
277,Saïd Benrahma,dz ALG,"FW,MF",Lyon,fr Ligue 1,27,1995,8.6,9,7,1,6,2,5,7,71.4,2,7,0,7,1,10,3,0,Matches
278,Ramy Bensebaini,dz ALG,DF,Dortmund,de Bundesliga,28,1995,11.5,34,21,21,11,2,24,34,70.6,10,22,7,15,16,50,37,0,Matches
279,Nabil Bentaleb,dz ALG,MF,Lille,fr Ligue 1,28,1994,21.9,49,32,29,18,2,22,43,51.2,21,33,12,21,37,86,33,0,Matches
280,Rodrigo Bentancur,uy URU,MF,Tottenham,eng Premier League,26,1997,11.2,23,15,10,11,2,10,24,41.7,14,15,4,11,17,40,16,1,Matches
281,Daniel Bentley,eng ENG,GK,Wolves,eng Premier League,30,1993,4.3,0,0,0,0,0,0,1,0.0,1,0,0,0,0,0,1,0,Matches
282,Lucas Beraldo,br BRA,DF,Paris S-G,fr Ligue 1,19,2003,11.2,22,14,14,8,0,10,25,40.0,15,15,6,9,20,42,25,0,Matches
283,Domenico Berardi,it ITA,FW,Sassuolo,it Serie A,28,1994,15.9,17,8,7,9,1,2,21,9.5,19,17,0,17,13,30,9,0,Matches
284,Yuri Berchiche,es ESP,DF,Athletic Club,es La Liga,33,1990,21.4,33,25,13,14,6,19,33,57.6,14,28,9,19,20,53,62,0,Matches
285,Álex Berenguer,es ESP,FW,Athletic Club,es La Liga,28,1995,17.7,23,14,9,9,5,7,24,29.2,17,23,0,23,5,28,13,0,Matches
286,Bartosz Bereszyński,pl POL,DF,Empoli,it Serie A,31,1992,19.6,41,25,25,13,3,24,40,60.0,16,22,10,12,21,62,52,0,Matches
287,Jóhann Berg Guðmundsson,is ISL,"MF,FW",Burnley,eng Premier League,32,1990,13.2,13,4,6,5,2,7,16,43.8,9,14,0,14,16,29,16,0,Matches
288,Sander Berge,no NOR,MF,Burnley,eng Premier League,25,1998,33.4,76,46,35,36,5,34,58,58.6,24,49,20,29,23,99,60,2,Matches
289,Etrit Berisha,al ALB,GK,Empoli,it Serie A,34,1989,14.0,0,0,0,0,0,0,1,0.0,1,0,0,0,0,0,7,1,Matches
290,Medon Berisha,al ALB,"FW,MF",Lecce,it Serie A,19,2003,2.3,3,1,3,0,0,0,2,0.0,2,2,2,0,1,4,0,0,Matches
291,Mergim Berisha,de GER,FW,Hoffenheim,de Bundesliga,25,1998,1.6,0,0,0,0,0,0,0,,0,2,1,1,0,0,0,0,Matches
292,Mergim Berisha,de GER,FW,Augsburg,de Bundesliga,25,1998,1.4,0,0,0,0,0,0,0,,0,1,0,1,0,0,3,0,Matches
293,Bernardo,br BRA,DF,Bochum,de Bundesliga,28,1995,32.5,99,58,56,35,8,45,69,65.2,24,66,30,36,55,154,120,1,Matches
294,Victor Bernth Kristiansen,dk DEN,DF,Bologna,it Serie A,20,2002,25.6,52,34,23,22,7,20,35,57.1,15,35,8,27,12,64,45,1,Matches
295,Matúš Bero,sk SVK,"MF,FW",Bochum,de Bundesliga,27,1995,18.5,32,22,13,12,7,13,32,40.6,19,24,3,21,12,44,26,0,Matches
296,Luke Berry,eng ENG,"MF,DF",Luton Town,eng Premier League,31,1992,3.6,7,2,2,4,1,2,3,66.7,1,6,1,5,0,7,3,0,Matches
297,Dimitry Bertaud,cd COD,GK,Montpellier,fr Ligue 1,25,1998,4.0,0,0,0,0,0,0,0,,0,0,0,0,0,0,0,0,Matches
298,Jan-Niklas Beste,de GER,"FW,MF",Heidenheim,de Bundesliga,24,1999,28.9,77,49,35,24,18,28,55,50.9,27,48,1,47,18,95,31,0,Matches
299,Beto,gw GNB,FW,Everton,eng Premier League,25,1998,10.6,14,6,1,6,7,4,12,33.3,8,11,0,11,1,15,14,0,Matches
300,Beto,gw GNB,FW,Udinese,it Serie A,25,1998,0.8,1,0,0,0,1,0,0,,0,0,0,0,0,1,0,0,Matches
301,Davide Bettella,it ITA,MF,Monza,it Serie A,23,2000,0.0,0,0,0,0,0,0,0,,0,0,0,0,0,0,0,0,Matches
302,Sam Beukema,nl NED,DF,Bologna,it Serie A,24,1998,28.3,27,11,14,11,2,16,25,64.0,9,35,21,14,15,42,99,2,Matches
303,Jordan Beyer,de GER,DF,Burnley,eng Premier League,23,2000,13.7,35,20,22,12,1,14,24,58.3,10,22,15,7,16,51,68,1,Matches
304,Pep Biel,es ESP,"MF,FW",Augsburg,de Bundesliga,26,1996,3.2,4,3,0,2,2,1,3,33.3,2,2,1,1,2,6,2,0,Matches
305,Jaka Bijol,si SVN,DF,Udinese,it Serie A,24,1999,23.2,43,27,34,9,0,22,35,62.9,13,36,21,15,23,66,140,1,Matches
306,El Bilal Touré,ml MLI,FW,Atalanta,it Serie A,21,2001,4.4,1,1,0,1,0,0,1,0.0,1,0,0,0,1,2,2,0,Matches
307,Philip Billing,dk DEN,MF,Bournemouth,eng Premier League,27,1996,15.5,33,16,7,22,4,9,27,33.3,18,31,5,26,20,53,28,1,Matches
308,Cristiano Biraghi,it ITA,DF,Fiorentina,it Serie A,30,1992,26.2,47,28,20,24,3,28,52,53.8,24,30,5,25,14,61,43,0,Matches
309,Davide Biraschi,it ITA,DF,Genoa,it Serie A,29,1994,1.0,3,3,1,2,0,1,3,33.3,2,0,0,0,2,5,5,0,Matches
310,Samuele Birindelli,it ITA,DF,Monza,it Serie A,24,1999,22.4,28,19,16,7,5,14,25,56.0,11,30,11,19,18,46,48,0,Matches
311,Tom Bischof,de GER,"MF,FW",Hoffenheim,de Bundesliga,18,2005,2.0,8,4,6,1,1,2,9,22.2,7,3,0,3,1,9,2,0,Matches
312,Yves Bissouma,ml MLI,MF,Tottenham,eng Premier League,26,1996,23.0,80,52,32,36,12,41,61,67.2,20,28,5,23,37,117,43,3,Matches
313,Leonardo Bittencourt,de GER,MF,Werder Bremen,de Bundesliga,29,1993,17.5,42,18,20,17,5,15,39,38.5,24,18,1,17,13,55,6,0,Matches
314,Marco Bizot,nl NED,GK,Brest,fr Ligue 1,32,1991,32.0,0,0,0,0,0,0,1,0.0,1,0,0,0,0,0,18,3,Matches
315,Antonio Blanco,es ESP,MF,Alavés,es La Liga,23,2000,27.0,61,36,29,27,5,31,86,36.0,55,25,2,23,35,96,30,0,Matches
316,Rubén Blanco,es ESP,GK,Marseille,fr Ligue 1,28,1995,1.3,0,0,0,0,0,0,0,,0,0,0,0,0,0,0,0,Matches
317,Hendry Blank,de GER,DF,Dortmund,de Bundesliga,18,2004,0.5,1,0,1,0,0,1,1,100.0,0,1,0,1,0,1,4,0,Matches
318,Ludovic Blas,fr FRA,"FW,MF",Rennes,fr Ligue 1,25,1997,17.4,30,14,16,13,1,12,28,42.9,16,13,1,12,6,36,9,0,Matches
319,Janis Blaswich,de GER,GK,RB Leipzig,de Bundesliga,32,1991,21.0,1,1,1,0,0,0,0,,0,0,0,0,0,1,7,3,Matches
320,Alexis Blin,fr FRA,MF,Lecce,it Serie A,26,1996,18.2,33,19,11,19,3,15,43,34.9,28,16,2,14,22,55,39,0,Matches
321,Daley Blind,nl NED,DF,Girona,es La Liga,33,1990,33.0,47,21,33,13,1,29,47,61.7,18,37,19,18,21,68,113,0,Matches
322,Myron Boadu,nl NED,FW,Monaco,fr Ligue 1,22,2001,0.9,2,2,0,1,1,1,2,50.0,1,2,0,2,0,2,0,0,Matches
323,Benicio Boaitey,eng ENG,"FW,DF",Brighton,eng Premier League,19,2004,0.4,0,0,0,0,0,0,1,0.0,1,1,0,1,0,0,2,0,Matches
324,Jérôme Boateng,de GER,DF,Salernitana,it Serie A,34,1988,2.6,0,0,0,0,0,0,0,,0,6,5,1,4,4,21,0,Matches
325,Oscar Bobb,no NOR,"FW,MF",Manchester City,eng Premier League,20,2003,3.4,7,3,1,2,4,2,4,50.0,2,4,0,4,5,12,1,0,Matches
326,Sacha Boey,fr FRA,DF,Bayern Munich,de Bundesliga,22,2000,1.2,2,0,2,0,0,1,2,50.0,1,1,0,1,1,3,2,0,Matches
327,Jeremie Boga,ci CIV,FW,Nice,fr Ligue 1,26,1997,22.2,18,7,6,10,2,10,20,50.0,10,26,2,24,8,26,4,0,Matches
328,Jayden Bogle,eng ENG,DF,Sheffield Utd,eng Premier League,23,2000,31.0,66,36,43,21,2,35,70,50.0,35,42,11,31,32,98,97,0,Matches
329,Emil Bohinen,no NOR,MF,Genoa,it Serie A,24,1999,0.6,1,1,0,1,0,0,0,,0,1,0,1,0,1,3,0,Matches
330,Emil Bohinen,no NOR,MF,Salernitana,it Serie A,24,1999,5.9,8,6,5,3,0,2,10,20.0,8,8,2,6,14,22,6,1,Matches
331,Adama Bojang,gm GAM,FW,Reims,fr Ligue 1,19,2004,0.9,2,1,1,0,1,0,0,,0,2,1,1,1,3,0,0,Matches
332,Daniel Boloca,ro ROU,MF,Sassuolo,it Serie A,24,1998,22.5,48,33,18,25,5,27,46,58.7,19,23,13,10,14,62,33,2,Matches
333,Willy Boly,ci CIV,DF,Nott'ham Forest,eng Premier League,32,1991,16.0,46,29,36,9,1,22,40,55.0,18,32,21,11,25,71,90,0,Matches
334,Giacomo Bonaventura,it ITA,MF,Fiorentina,it Serie A,33,1989,25.3,26,13,6,10,10,9,21,42.9,12,16,1,15,14,40,10,0,Matches
335,Federico Bonazzoli,it ITA,"FW,MF",Hellas Verona,it Serie A,26,1997,11.3,4,1,1,3,0,1,8,12.5,7,9,1,8,3,7,3,0,Matches
336,Warren Bondo,fr FRA,MF,Monza,it Serie A,19,2003,16.4,29,22,16,10,3,13,17,76.5,4,13,3,10,6,35,13,0,Matches
337,Giovanni Bonfanti,it ITA,DF,Atalanta,it Serie A,20,2003,1.0,4,2,2,2,0,2,3,66.7,1,1,1,0,1,5,1,0,Matches
338,Victor Boniface,ng NGA,FW,Leverkusen,de Bundesliga,22,2000,17.2,6,4,0,1,5,1,4,25.0,3,6,1,5,0,6,13,0,Matches
339,Kevin Bonifazi,it ITA,DF,Bologna,it Serie A,27,1996,1.0,4,0,0,4,0,1,2,50.0,1,0,0,0,0,4,7,1,Matches
340,Kevin Bonifazi,it ITA,DF,Frosinone,it Serie A,27,1996,3.4,5,3,2,3,0,2,3,66.7,1,1,0,1,3,8,9,0,Matches
341,Leonardo Bonucci,it ITA,DF,Union Berlin,de Bundesliga,36,1987,5.1,6,5,2,4,0,4,4,100.0,0,5,3,2,7,13,16,0,Matches
342,Neto Borges,br BRA,DF,Clermont Foot,fr Ligue 1,26,1996,28.0,48,24,25,18,5,28,63,44.4,35,28,6,22,57,105,84,0,Matches
343,Yvandro Borges Sanches,lu LUX,"MF,FW",Gladbach,de Bundesliga,19,2004,0.2,0,0,0,0,0,0,0,,0,0,0,0,0,0,0,0,Matches
344,Sebastiaan Bornauw,be BEL,DF,Wolfsburg,de Bundesliga,24,1999,15.9,26,12,19,7,0,13,19,68.4,6,21,12,9,18,44,81,0,Matches
345,Rafael Borré,co COL,FW,Werder Bremen,de Bundesliga,27,1995,11.0,10,7,2,4,4,5,16,31.3,11,8,2,6,2,12,10,0,Matches
346,Gennaro Borrelli,it ITA,FW,Frosinone,it Serie A,23,2000,0.3,0,0,0,0,0,0,0,,0,0,0,0,0,0,0,0,Matches
347,Adri Bosch,es ESP,DF,Granada,es La Liga,22,2001,0.3,1,1,1,0,0,0,0,,0,0,0,0,0,1,1,0,Matches
348,Erik Botheim,no NOR,"FW,MF",Salernitana,it Serie A,23,2000,3.5,2,0,2,0,0,0,1,0.0,1,3,0,3,0,2,2,0,Matches
349,Sven Botman,nl NED,DF,Newcastle Utd,eng Premier League,23,2000,15.3,20,13,14,6,0,8,13,61.5,5,20,16,4,9,29,61,3,Matches
350,Saïmon Bouabré,fr FRA,MF,Monaco,fr Ligue 1,17,2006,0.5,2,2,0,2,0,1,2,50.0,1,1,0,1,0,2,0,0,Matches
351,Ayyoub Bouaddi,fr FRA,MF,Lille,fr Ligue 1,15,2007,1.5,6,2,6,0,0,2,5,40.0,3,2,0,2,1,7,3,0,Matches
352,Badredine Bouanani,dz ALG,FW,Nice,fr Ligue 1,18,2004,1.8,3,2,1,1,1,3,4,75.0,1,5,0,5,3,6,0,0,Matches
353,Badredine Bouanani,dz ALG,MF,Lorient,fr Ligue 1,18,2004,4.9,4,2,1,1,2,2,4,50.0,2,3,0,3,2,6,3,0,Matches
354,Mohamed Bouchenna,fr FRA,"MF,FW",Clermont Foot,fr Ligue 1,17,2006,0.3,1,0,1,0,0,0,0,,0,0,0,0,0,1,0,0,Matches
355,Hicham Boudaoui,dz ALG,MF,Nice,fr Ligue 1,23,1999,17.9,41,19,16,22,3,21,30,70.0,9,15,1,14,11,52,15,0,Matches
356,Yassine Bounou,ma MAR,GK,Sevilla,es La Liga,32,1991,1.0,0,0,0,0,0,0,0,,0,0,0,0,0,0,0,0,Matches
357,Mehdi Bourabia,ma MAR,MF,Frosinone,it Serie A,31,1991,2.2,5,4,1,4,0,2,4,50.0,2,3,0,3,0,5,4,0,Matches
358,Benjamin Bourigeaud,fr FRA,"MF,FW",Rennes,fr Ligue 1,29,1994,26.9,31,18,14,9,8,13,44,29.5,31,31,2,29,22,53,39,2,Matches
359,Bilal Boutobba,fr FRA,"FW,MF",Clermont Foot,fr Ligue 1,24,1998,10.3,22,12,6,10,6,10,23,43.5,13,9,0,9,8,30,3,0,Matches
360,Hugo Boutsingkham,fr FRA,"MF,FW",Nantes,fr Ligue 1,20,2003,0.1,0,0,0,0,0,0,0,,0,0,0,0,0,0,1,0,Matches
361,Edoardo Bove,it ITA,MF,Roma,it Serie A,21,2002,19.8,60,31,16,31,13,27,46,58.7,19,21,1,20,11,71,11,1,Matches
362,Jarrod Bowen,eng ENG,FW,West Ham,eng Premier League,26,1996,33.5,42,28,14,14,14,13,35,37.1,22,37,5,32,19,61,14,0,Matches
363,Lucas Boyé,ar ARG,FW,Granada,es La Liga,27,1996,28.2,50,25,14,25,11,14,34,41.2,20,35,5,30,10,60,46,0,Matches
364,Domagoj Bradarić,hr CRO,DF,Salernitana,it Serie A,23,1999,30.5,29,20,13,10,6,15,25,60.0,10,22,7,15,32,61,62,1,Matches
365,Conor Bradley,nir NIR,DF,Liverpool,eng Premier League,20,2003,8.4,33,25,14,12,7,24,38,63.2,14,17,1,16,10,43,14,0,Matches
366,Bilal Brahimi,dz ALG,FW,Nice,fr Ligue 1,23,2000,0.1,0,0,0,0,0,0,1,0.0,1,0,0,0,0,0,0,0,Matches
367,Bilal Brahimi,dz ALG,"FW,MF",Brest,fr Ligue 1,23,2000,2.5,0,0,0,0,0,0,3,0.0,3,3,0,3,0,0,0,0,Matches
368,Julian Brandt,de GER,"MF,FW",Dortmund,de Bundesliga,27,1996,24.7,17,14,8,8,1,10,27,37.0,17,20,3,17,8,25,18,0,Matches
369,Jarrad Branthwaite,eng ENG,DF,Everton,eng Premier League,21,2002,34.6,66,32,42,22,2,45,62,72.6,17,51,36,15,50,116,163,2,Matches
370,Darko Brašanac,rs SRB,MF,Osasuna,es La Liga,31,1992,0.5,1,0,1,0,0,1,1,100.0,0,1,0,1,0,1,0,0,Matches
371,Lilian Brassier,fr FRA,DF,Brest,fr Ligue 1,23,1999,29.7,31,18,18,13,0,12,24,50.0,12,28,21,7,41,72,93,0,Matches
372,Brau,es ESP,DF,Granada,es La Liga,21,2001,0.3,1,0,1,0,0,1,1,100.0,0,0,0,0,0,1,2,0,Matches
373,Claudio Bravo,cl CHI,GK,Betis,es La Liga,40,1983,7.0,0,0,0,0,0,0,1,0.0,1,0,0,0,0,0,2,0,Matches
374,Fabian Bredlow,de GER,GK,Stuttgart,de Bundesliga,28,1995,4.0,0,0,0,0,0,0,1,0.0,1,0,0,0,0,0,3,0,Matches
375,Tim Breithaupt,de GER,MF,Augsburg,de Bundesliga,21,2002,7.0,20,11,11,9,0,13,21,61.9,8,15,3,12,8,28,10,0,Matches
376,Josip Brekalo,hr CRO,FW,Fiorentina,it Serie A,25,1998,7.2,8,6,6,2,0,2,11,18.2,9,7,0,7,1,9,0,0,Matches
377,Gleison Bremer,br BRA,DF,Juventus,it Serie A,26,1997,35.9,58,42,32,21,5,21,29,72.4,8,45,27,18,40,98,147,0,Matches
378,Brenner,br BRA,"MF,FW",Udinese,it Serie A,23,2000,2.1,8,7,1,5,2,4,7,57.1,3,2,0,2,0,8,2,0,Matches
379,Ben Brereton,cl CHI,"FW,MF",Sheffield Utd,eng Premier League,24,1999,12.3,9,4,4,4,1,4,10,40.0,6,9,3,6,3,12,12,0,Matches
380,Ben Brereton,cl CHI,"FW,MF",Villarreal,es La Liga,24,1999,3.0,2,2,1,0,1,0,2,0.0,2,0,0,0,0,2,0,0,Matches
381,Marco Brescianini,it ITA,MF,Frosinone,it Serie A,23,2000,25.8,28,13,13,12,3,9,25,36.0,16,22,5,17,10,38,37,0,Matches
382,Maximilian Breunig,de GER,FW,Freiburg,de Bundesliga,22,2000,0.1,0,0,0,0,0,0,0,,0,1,0,1,0,0,0,0,Matches
383,Rhian Brewster,eng ENG,"FW,MF",Sheffield Utd,eng Premier League,23,2000,3.8,5,1,1,2,2,0,2,0.0,2,2,0,2,1,6,2,0,Matches
384,Bennit Bröger,de GER,FW,Wolfsburg,de Bundesliga,17,2006,0.1,0,0,0,0,0,0,0,,0,0,0,0,0,0,0,0,Matches
385,Armando Broja,al ALB,FW,Chelsea,eng Premier League,21,2001,5.0,3,0,0,1,2,1,2,50.0,1,5,1,4,0,3,3,0,Matches
386,Armando Broja,al ALB,FW,Fulham,eng Premier League,21,2001,1.0,0,0,0,0,0,0,0,,0,1,0,1,0,0,0,0,Matches
387,Dylan Bronn,tn TUN,"DF,MF",Salernitana,it Serie A,28,1995,0.6,0,0,0,0,0,0,1,0.0,1,2,0,2,0,0,4,0,Matches
388,Andre Brooks,eng ENG,"MF,DF",Sheffield Utd,eng Premier League,19,2003,10.4,22,13,7,11,4,9,21,42.9,12,13,1,12,14,36,20,0,Matches
389,David Brooks,wls WAL,"FW,MF",Bournemouth,eng Premier League,26,1997,3.1,5,4,2,1,2,2,4,50.0,2,3,0,3,2,7,2,0,Matches
390,John Brooks,us USA,DF,Hoffenheim,de Bundesliga,30,1993,17.1,28,15,17,10,1,15,30,50.0,15,29,17,12,27,55,109,1,Matches
391,Moritz Broschinski,de GER,FW,Bochum,de Bundesliga,22,2000,13.9,11,7,2,5,4,2,8,25.0,6,11,2,9,0,11,6,0,Matches
392,Jacob Brown,sct SCO,"MF,FW",Luton Town,eng Premier League,25,1998,11.3,19,12,7,7,5,7,18,38.9,11,20,1,19,8,27,22,0,Matches
393,Josh Brownhill,eng ENG,MF,Burnley,eng Premier League,27,1995,25.0,61,35,23,28,10,27,37,73.0,10,33,8,25,34,95,40,1,Matches
394,Alexander Brunst,de GER,GK,Darmstadt 98,de Bundesliga,28,1995,3.0,0,0,0,0,0,0,2,0.0,2,0,0,0,0,0,2,1,Matches
395,Jacob Bruun Larsen,dk DEN,"MF,FW",Burnley,eng Premier League,24,1998,13.9,9,4,4,3,2,7,21,33.3,14,16,2,14,7,16,23,0,Matches
396,Tajon Buchanan,ca CAN,DF,Inter,it Serie A,24,1999,1.8,1,1,0,0,1,1,2,50.0,1,1,0,1,0,1,4,0,Matches
397,Ante Budimir,hr CRO,FW,Osasuna,es La Liga,32,1991,27.1,21,15,2,11,8,5,14,35.7,9,19,5,14,5,26,18,0,Matches
398,Hugo Bueno,es ESP,"DF,MF",Wolves,eng Premier League,20,2002,8.2,21,14,12,7,2,12,19,63.2,7,17,4,13,6,27,24,0,Matches
399,Manu Bueno,es ESP,MF,Sevilla,es La Liga,19,2004,1.3,4,2,4,0,0,3,3,100.0,0,3,0,3,0,4,1,0,Matches
400,Santiago Bueno,uy URU,DF,Wolves,eng Premier League,24,1998,9.1,13,7,5,7,1,5,11,45.5,6,22,12,10,6,19,33,0,Matches
401,Marius Bülter,de GER,"DF,FW",Hoffenheim,de Bundesliga,30,1993,15.0,18,11,9,5,4,12,23,52.2,11,17,3,14,10,28,20,0,Matches
402,Facundo Buonanotte,ar ARG,"FW,MF",Brighton,eng Premier League,18,2004,15.2,42,22,13,22,7,14,44,31.8,30,22,3,19,8,50,5,0,Matches
403,Alessandro Buongiorno,it ITA,DF,Torino,it Serie A,24,1999,28.1,70,39,43,24,3,24,34,70.6,10,20,12,8,69,139,131,0,Matches
404,Jonathan Burkardt,de GER,"FW,MF",Mainz 05,de Bundesliga,23,2000,17.1,12,8,2,6,4,4,11,36.4,7,16,3,13,3,15,2,0,Matches
405,Oliver Burke,sct SCO,FW,Werder Bremen,de Bundesliga,26,1997,0.4,0,0,0,0,0,0,2,0.0,2,0,0,0,0,0,0,0,Matches
406,Reece Burke,eng ENG,DF,Luton Town,eng Premier League,26,1996,18.4,37,23,17,14,6,12,26,46.2,14,25,18,7,18,55,78,1,Matches
407,Dan Burn,eng ENG,DF,Newcastle Utd,eng Premier League,31,1992,30.3,61,33,37,20,4,26,61,42.6,35,55,25,30,37,98,124,1,Matches
408,Rareș-Cătălin Burnete,ro ROU,FW,Lecce,it Serie A,19,2004,0.1,0,0,0,0,0,0,0,,0,0,0,0,0,0,0,0,Matches
409,Mason Burstow,eng ENG,FW,Chelsea,eng Premier League,19,2003,0.1,0,0,0,0,0,0,0,,0,0,0,0,0,0,0,0,Matches
410,Marnon Busch,de GER,DF,Heidenheim,de Bundesliga,28,1994,6.6,11,9,6,3,2,7,12,58.3,5,9,2,7,10,21,12,0,Matches
411,Maxime Busi,be BEL,"FW,DF",Reims,fr Ligue 1,23,1999,1.8,2,0,0,1,1,0,2,0.0,2,6,1,5,4,6,5,0,Matches
412,Pablo Busto,es ESP,DF,Betis,es La Liga,17,2005,0.5,1,1,0,0,1,1,1,100.0,0,0,0,0,1,2,3,0,Matches
413,Aurélio Buta,pt POR,"DF,MF",Eint Frankfurt,de Bundesliga,26,1997,19.4,40,25,19,16,5,21,38,55.3,17,24,5,19,15,55,36,0,Matches
414,Marcin Bułka,pl POL,GK,Nice,fr Ligue 1,23,1999,34.0,0,0,0,0,0,0,2,0.0,2,0,0,0,0,0,9,3,Matches
415,Rémy Cabella,fr FRA,"FW,MF",Lille,fr Ligue 1,33,1990,16.4,54,36,19,20,15,20,54,37.0,34,32,0,32,5,59,5,0,Matches
416,Jovane Cabral,cv CPV,"MF,FW",Salernitana,it Serie A,25,1998,7.5,13,9,4,7,2,3,9,33.3,6,3,0,3,1,14,4,0,Matches
417,Liberato Cacace,nz NZL,DF,Empoli,it Serie A,22,2000,21.2,40,24,24,13,3,24,38,63.2,14,23,6,17,19,59,56,0,Matches
418,Anthony Caci,fr FRA,DF,Mainz 05,de Bundesliga,26,1997,27.6,56,23,30,25,1,27,44,61.4,17,43,7,36,32,88,45,0,Matches
419,Moisés Caicedo,ec ECU,MF,Chelsea,eng Premier League,21,2001,31.8,91,46,38,42,11,36,60,60.0,24,59,25,34,37,128,44,4,Matches
420,Tom Cairney,sct SCO,MF,Fulham,eng Premier League,32,1991,16.5,24,16,10,12,2,13,25,52.0,12,16,4,12,13,37,6,0,Matches
421,Jens Cajuste,se SWE,MF,Napoli,it Serie A,23,1999,11.3,36,24,13,17,6,20,37,54.1,17,20,3,17,4,40,15,0,Matches
422,Davide Calabria,it ITA,DF,Milan,it Serie A,26,1996,24.3,70,38,38,25,7,44,72,61.1,28,26,7,19,24,94,49,1,Matches
423,Riccardo Calafiori,it ITA,DF,Bologna,it Serie A,21,2002,26.1,47,32,28,16,3,22,32,68.8,10,38,13,25,50,97,74,3,Matches
424,Mattia Caldara,it ITA,DF,Milan,it Serie A,29,1994,0.4,1,1,1,0,0,1,1,100.0,0,1,1,0,1,2,1,0,Matches
425,Luca Caldirola,it ITA,DF,Monza,it Serie A,32,1991,23.8,25,14,19,4,2,13,22,59.1,9,26,17,9,29,54,53,0,Matches
426,Duje Ćaleta-Car,hr CRO,DF,Lyon,fr Ligue 1,26,1996,22.1,26,11,19,6,1,18,22,81.8,4,27,14,13,18,44,94,1,Matches
427,Hakan Çalhanoğlu,tr TUR,MF,Inter,it Serie A,29,1994,28.4,66,33,29,29,8,32,49,65.3,17,29,13,16,24,90,22,0,Matches
428,José Callejón,es ESP,"MF,FW",Granada,es La Liga,36,1987,8.9,13,6,10,3,0,8,22,36.4,14,7,1,6,5,18,10,0,Matches
429,Dominic Calvert-Lewin,eng ENG,FW,Everton,eng Premier League,26,1997,24.1,13,6,2,6,5,2,15,13.3,13,14,4,10,4,17,38,0,Matches
430,Lamine Camara,sn SEN,MF,Metz,fr Ligue 1,19,2004,25.1,62,42,26,30,6,24,49,49.0,25,35,2,33,28,90,34,0,Matches
431,Mahdi Camara,fr FRA,MF,Brest,fr Ligue 1,25,1998,22.4,55,39,8,40,7,20,49,40.8,29,24,1,23,27,82,19,0,Matches
432,Mohamed Camara,ml MLI,MF,Monaco,fr Ligue 1,23,2000,11.5,35,21,10,20,5,15,29,51.7,14,8,2,6,11,46,7,0,Matches
433,Francesco Camarda,it ITA,FW,Milan,it Serie A,15,2008,0.2,0,0,0,0,0,0,2,0.0,2,0,0,0,0,0,0,0,Matches
434,Eduardo Camavinga,fr FRA,"MF,DF",Real Madrid,es La Liga,20,2002,20.2,76,47,39,29,8,23,39,59.0,16,36,8,28,29,105,29,1,Matches
435,Nicolò Cambiaghi,it ITA,"FW,MF",Empoli,it Serie A,22,2000,28.4,51,39,15,20,16,16,35,45.7,19,26,1,25,14,65,8,0,Matches
436,Andrea Cambiaso,it ITA,"DF,FW",Juventus,it Serie A,23,2000,26.4,47,30,23,15,9,25,43,58.1,18,28,3,25,11,58,26,1,Matches
437,Axel Camblan,fr FRA,FW,Brest,fr Ligue 1,19,2003,1.0,3,1,0,2,1,2,4,50.0,2,2,0,2,0,3,0,0,Matches
438,Sergio Camello,es ESP,FW,Rayo Vallecano,es La Liga,22,2001,18.5,16,5,3,10,3,6,15,40.0,9,10,2,8,3,19,15,0,Matches
439,José Campaña,es ESP,MF,Las Palmas,es La Liga,30,1993,1.9,2,2,1,1,0,0,2,0.0,2,3,2,1,2,4,3,0,Matches
440,Emre Can,de GER,"MF,DF",Dortmund,de Bundesliga,29,1994,21.7,63,45,37,23,3,28,48,58.3,20,30,7,23,22,85,41,2,Matches
441,Matteo Cancellieri,it ITA,"FW,MF",Empoli,it Serie A,21,2002,19.9,35,22,12,16,7,13,36,36.1,23,19,0,19,6,41,18,0,Matches
442,João Cancelo,pt POR,DF,Barcelona,es La Liga,29,1994,27.8,64,44,35,21,8,38,58,65.5,20,35,6,29,29,93,59,1,Matches
443,Fali Candé,gw GNB,DF,Metz,fr Ligue 1,25,1998,20.5,40,19,31,9,0,20,35,57.1,15,41,28,13,20,60,107,1,Matches
444,Antonio Candreva,it ITA,"MF,FW",Salernitana,it Serie A,36,1987,30.6,18,13,8,8,2,9,25,36.0,16,9,0,9,7,25,23,0,Matches
445,Thomas Cannon,ie IRL,FW,Everton,eng Premier League,20,2002,0.0,0,0,0,0,0,0,0,,0,0,0,0,0,0,0,0,Matches
446,Sergi Canós,es ESP,"MF,FW",Valencia,es La Liga,26,1997,13.7,23,13,7,11,5,10,24,41.7,14,14,2,12,11,34,9,0,Matches
447,Luigi Canotto,it ITA,FW,Frosinone,it Serie A,29,1994,0.2,0,0,0,0,0,0,0,,0,0,0,0,0,0,0,0,Matches
448,Gino Caoki,fr FRA,MF,Lorient,fr Ligue 1,19,2004,0.1,0,0,0,0,0,0,1,0.0,1,0,0,0,0,0,0,0,Matches
449,Étienne Capoue,fr FRA,MF,Villarreal,es La Liga,35,1988,16.2,32,18,17,12,3,15,22,68.2,7,20,4,16,22,54,24,1,Matches
450,Gianluca Caprari,it ITA,"MF,FW",Monza,it Serie A,30,1993,3.2,2,1,1,1,0,0,1,0.0,1,0,0,0,2,4,0,0,Matches
451,Elia Caprile,it ITA,GK,Empoli,it Serie A,21,2001,23.0,1,0,1,0,0,1,1,100.0,0,0,0,0,0,1,16,2,Matches
452,Francesco Caputo,it ITA,FW,Empoli,it Serie A,35,1987,14.1,2,0,0,0,2,0,1,0.0,1,4,0,4,1,3,3,0,Matches
453,Maxence Caqueret,fr FRA,MF,Lyon,fr Ligue 1,23,2000,33.6,91,64,39,37,15,38,107,35.5,69,40,9,31,48,139,26,2,Matches
454,Andrea Carboni,it ITA,DF,Monza,it Serie A,22,2001,16.5,38,22,24,12,2,20,31,64.5,11,23,13,10,17,55,56,1,Matches
455,Valentin Carboni,ar ARG,"MF,FW",Monza,it Serie A,18,2005,13.0,25,15,10,12,3,8,26,30.8,18,12,1,11,7,32,4,0,Matches
456,Isaac Carcelen,es ESP,DF,Cádiz,es La Liga,30,1993,29.0,50,31,30,15,5,25,45,55.6,20,24,7,17,27,77,87,2,Matches
457,Dani Cárdenas,es ESP,GK,Rayo Vallecano,es La Liga,26,1997,1.0,0,0,0,0,0,0,0,,0,0,0,0,0,0,1,0,Matches
458,Irvin Cardona,mt MLT,"MF,DF",Augsburg,de Bundesliga,25,1997,0.6,1,1,0,0,1,1,3,33.3,2,1,0,1,0,1,1,0,Matches
459,Marc Cardona,es ESP,FW,Las Palmas,es La Liga,28,1995,8.2,9,8,3,4,2,1,12,8.3,11,5,0,5,2,11,7,0,Matches
460,Sergi Cardona,es ESP,DF,Las Palmas,es La Liga,24,1999,31.3,90,55,52,29,9,55,96,57.3,41,45,7,38,46,136,102,0,Matches
461,Johnny Cardoso,us USA,MF,Betis,es La Liga,21,2001,14.8,48,29,19,24,5,22,33,66.7,11,20,5,15,32,80,31,0,Matches
462,Igor Carioca,br BRA,"DF,MF",Lorient,fr Ligue 1,26,1996,2.9,8,6,6,1,1,4,6,66.7,2,0,0,0,3,11,6,0,Matches
463,Diego Carlos,br BRA,DF,Aston Villa,eng Premier League,30,1993,20.2,27,16,22,4,1,13,21,61.9,8,24,19,5,13,40,78,3,Matches
464,Carmona,es ESP,"DF,MF",Getafe,es La Liga,21,2002,14.6,30,21,13,14,3,9,28,32.1,19,15,2,13,21,51,25,0,Matches
465,Marco Carnesecchi,it ITA,GK,Atalanta,it Serie A,23,2000,26.9,0,0,0,0,0,0,0,,0,0,0,0,0,0,22,3,Matches
466,Yannick Carrasco,be BEL,DF,Atlético Madrid,es La Liga,29,1993,2.5,4,4,3,1,0,2,7,28.6,5,2,0,2,1,5,6,0,Matches
467,Álvaro Carreras,es ESP,"MF,FW",Granada,es La Liga,20,2003,5.3,13,8,8,4,1,5,11,45.5,6,5,1,4,7,20,9,1,Matches
468,Rasmus Carstensen,dk DEN,"DF,FW",Köln,de Bundesliga,22,2000,18.4,47,22,23,20,4,31,56,55.4,25,38,9,29,20,67,50,2,Matches
469,Antonin Cartillier,fr FRA,DF,Monaco,fr Ligue 1,19,2004,0.1,0,0,0,0,0,0,0,,0,1,0,1,0,0,0,0,Matches
470,Dani Carvajal,es ESP,DF,Real Madrid,es La Liga,31,1992,24.1,47,32,28,15,4,23,42,54.8,19,28,9,19,22,69,54,4,Matches
471,Fabio Carvalho,pt POR,MF,RB Leipzig,de Bundesliga,20,2002,1.8,3,1,0,2,1,1,3,33.3,2,8,0,8,0,3,1,0,Matches
472,William Carvalho,pt POR,MF,Betis,es La Liga,31,1992,7.6,20,12,11,7,2,10,16,62.5,6,8,1,7,8,28,9,1,Matches
473,Cesare Casadei,it ITA,"FW,MF",Chelsea,eng Premier League,20,2003,0.9,5,3,2,1,2,2,5,40.0,3,1,0,1,0,5,4,0,Matches
474,Marc Casado,es ESP,MF,Barcelona,es La Liga,19,2003,0.2,1,1,1,0,0,1,1,100.0,0,0,0,0,1,2,2,0,Matches
475,Nicolò Casale,it ITA,DF,Lazio,it Serie A,25,1998,17.3,15,9,13,2,0,6,15,40.0,9,19,16,3,12,27,61,0,Matches
476,Casemiro,br BRA,"MF,DF",Manchester Utd,eng Premier League,31,1992,22.0,83,56,43,32,8,51,106,48.1,55,74,33,41,18,101,71,1,Matches
477,Kaelan Casey,eng ENG,DF,West Ham,eng Premier League,18,2004,0.0,0,0,0,0,0,0,0,,0,0,0,0,0,0,1,0,Matches
478,Matty Cash,pl POL,DF,Aston Villa,eng Premier League,25,1997,23.8,54,31,24,24,6,29,59,49.2,30,35,14,21,18,72,59,0,Matches
479,Josué Casimir,fr FRA,"FW,DF",Le Havre,fr Ligue 1,21,2001,22.4,31,18,14,14,3,7,18,38.9,11,23,2,21,13,44,25,0,Matches
480,Giuseppe Caso,it ITA,"FW,MF",Frosinone,it Serie A,24,1998,4.6,4,3,2,0,2,2,3,66.7,1,0,0,0,0,4,0,0,Matches
481,Cristian Cásseres Jr.,ve VEN,MF,Toulouse,fr Ligue 1,23,2000,21.6,70,34,31,33,6,29,61,47.5,32,34,4,30,27,97,33,1,Matches
482,Timothy Castagne,be BEL,DF,Fulham,eng Premier League,27,1995,29.3,49,24,23,16,10,26,44,59.1,18,38,10,28,38,87,69,1,Matches
483,Koen Casteels,be BEL,GK,Wolfsburg,de Bundesliga,31,1992,25.0,2,1,2,0,0,2,3,66.7,1,0,0,0,0,2,16,5,Matches
484,Valentín Castellanos,ar ARG,FW,Lazio,it Serie A,24,1998,18.7,22,10,1,12,9,6,20,30.0,14,22,2,20,2,24,18,0,Matches
485,Jean-Charles Castelletto,cm CMR,DF,Nantes,fr Ligue 1,28,1995,27.4,34,26,22,10,2,18,29,62.1,11,19,10,9,32,66,81,0,Matches
486,Samu Castillejo,es ESP,"FW,MF",Sassuolo,it Serie A,28,1995,6.0,12,10,5,5,2,7,19,36.8,12,16,1,15,1,13,3,0,Matches
487,Jonny Castro,es ESP,MF,Wolves,eng Premier League,29,1994,0.1,0,0,0,0,0,0,1,0.0,1,1,1,0,0,0,0,0,Matches
488,Santiago Castro,ar ARG,FW,Bologna,it Serie A,18,2004,2.7,2,1,0,1,1,1,3,33.3,2,1,0,1,1,3,1,0,Matches
489,Gaetano Castrovilli,it ITA,"FW,MF",Fiorentina,it Serie A,26,1997,4.1,3,2,1,2,0,1,8,12.5,7,4,0,4,2,5,3,0,Matches
490,Danilo Cataldi,it ITA,MF,Lazio,it Serie A,28,1994,15.1,24,12,7,16,1,8,18,44.4,10,15,7,8,17,41,19,1,Matches
491,Catena,es ESP,DF,Osasuna,es La Liga,28,1994,28.2,33,18,26,6,1,19,35,54.3,16,24,15,9,15,48,119,3,Matches
492,Maximiliano Caufriez,be BEL,DF,Clermont Foot,fr Ligue 1,26,1997,18.4,38,28,31,5,2,19,29,65.5,10,18,12,6,18,56,69,2,Matches
493,Ivan Cavaleiro,pt POR,FW,Lille,fr Ligue 1,29,1993,8.6,10,6,3,4,3,7,20,35.0,13,9,2,7,5,15,6,0,Matches
494,Dani Ceballos,es ESP,"MF,FW",Real Madrid,es La Liga,26,1996,6.6,10,5,4,5,1,5,14,35.7,9,9,2,7,0,10,4,1,Matches
495,Emil Ceide,no NOR,"FW,MF",Sassuolo,it Serie A,21,2001,2.0,2,2,1,1,0,1,1,100.0,0,6,1,5,0,2,0,0,Matches
496,Zeki Çelik,tr TUR,DF,Roma,it Serie A,26,1997,7.5,23,16,10,10,3,14,25,56.0,11,12,5,7,8,31,25,0,Matches
497,Álex Centelles,es ESP,DF,Almería,es La Liga,25,1997,10.9,11,6,9,2,0,8,18,44.4,10,5,2,3,18,29,29,0,Matches
498,Fabien Centonze,fr FRA,DF,Hellas Verona,it Serie A,27,1996,7.5,14,8,10,4,0,5,10,50.0,5,14,2,12,10,24,18,0,Matches
499,Fabien Centonze,fr FRA,DF,Nantes,fr Ligue 1,27,1996,1.0,2,1,2,0,0,2,3,66.7,1,2,1,1,0,2,1,0,Matches
500,Václav Černý,cz CZE,"FW,MF",Wolfsburg,de Bundesliga,25,1997,10.2,8,3,3,4,1,2,14,14.3,12,13,0,13,8,16,6,0,Matches
501,Michele Cerofolini,it ITA,GK,Frosinone,it Serie A,24,1999,7.5,0,0,0,0,0,0,0,,0,0,0,0,0,0,5,1,Matches
502,Alberto Cerri,it ITA,FW,Empoli,it Serie A,27,1996,6.1,3,3,1,1,1,2,5,40.0,3,3,1,2,3,6,7,0,Matches
503,Leonardo Cerri,it ITA,DF,Juventus,it Serie A,20,2003,0.1,0,0,0,0,0,0,0,,0,0,0,0,0,0,0,0,Matches
504,Franco Cervi,ar ARG,"MF,DF",Celta Vigo,es La Liga,29,1994,6.1,24,18,13,9,2,13,24,54.2,11,16,0,16,9,33,4,0,Matches
505,Julian Chabot,de GER,DF,Köln,de Bundesliga,25,1998,30.0,59,42,40,17,2,35,59,59.3,24,66,43,23,45,104,145,0,Matches
506,El Chadaille Bitshiabu,fr FRA,"DF,MF",RB Leipzig,de Bundesliga,18,2005,0.4,1,0,1,0,0,0,0,,0,0,0,0,1,2,4,0,Matches
507,Fares Chaïbi,dz ALG,"FW,MF",Toulouse,fr Ligue 1,20,2002,0.6,0,0,0,0,0,0,0,,0,0,0,0,0,0,2,0,Matches
508,Fares Chaïbi,dz ALG,"MF,FW",Eint Frankfurt,de Bundesliga,20,2002,21.2,27,17,7,12,8,8,18,44.4,10,37,1,36,5,32,19,0,Matches
509,Trevoh Chalobah,eng ENG,DF,Chelsea,eng Premier League,24,1999,10.6,16,12,10,2,4,10,15,66.7,5,8,7,1,8,24,51,0,Matches
510,Muhammed Cham,at AUT,"MF,FW",Clermont Foot,fr Ligue 1,22,2000,28.4,25,14,10,13,2,11,27,40.7,16,20,2,18,8,33,5,1,Matches
511,Calum Chambers,eng ENG,"MF,DF",Aston Villa,eng Premier League,28,1995,1.7,3,0,3,0,0,0,1,0.0,1,2,1,1,2,5,4,0,Matches
512,Timothy Chandler,us USA,"MF,DF",Eint Frankfurt,de Bundesliga,33,1990,0.2,0,0,0,0,0,0,0,,0,0,0,0,0,0,0,0,Matches
513,Brendan Chardonnet,fr FRA,DF,Brest,fr Ligue 1,28,1994,33.0,57,34,33,22,2,32,63,50.8,31,58,34,24,53,110,139,3,Matches
514,Charlys,br BRA,MF,Hellas Verona,it Serie A,19,2004,0.3,0,0,0,0,0,0,0,,0,0,0,0,1,1,0,0,Matches
515,Pep Chavarría,es ESP,"DF,MF",Rayo Vallecano,es La Liga,25,1998,13.0,23,18,15,6,2,11,17,64.7,6,15,3,12,6,29,29,1,Matches
516,Jhoanner Chávez,ec ECU,DF,Lens,fr Ligue 1,21,2002,5.3,6,5,2,2,2,3,9,33.3,6,2,0,2,5,11,11,0,Matches
517,Walid Cheddira,ma MAR,FW,Frosinone,it Serie A,25,1998,23.6,12,7,1,8,3,4,8,50.0,4,6,1,5,5,17,10,0,Matches
518,Rayan Cherki,fr FRA,"MF,FW",Lyon,fr Ligue 1,19,2003,19.1,28,15,4,16,8,17,46,37.0,29,13,3,10,7,35,1,0,Matches
519,Youssef Chermiti,pt POR,FW,Everton,eng Premier League,19,2004,2.3,3,2,2,1,0,1,5,20.0,4,4,1,3,1,4,2,0,Matches
520,Lucas Chevalier,fr FRA,GK,Lille,fr Ligue 1,21,2001,33.0,3,0,3,0,0,3,4,75.0,1,1,0,1,0,3,11,2,Matches
521,Fabio Chiarodia,it ITA,DF,Gladbach,de Bundesliga,18,2005,1.7,8,5,5,1,2,5,7,71.4,2,2,1,1,3,11,9,0,Matches
522,Federico Chiesa,it ITA,FW,Juventus,it Serie A,25,1997,24.4,20,10,7,6,7,3,13,23.1,10,17,1,16,6,26,4,0,Matches
523,Ben Chilwell,eng ENG,DF,Chelsea,eng Premier League,26,1996,8.4,15,10,5,9,1,5,8,62.5,3,11,3,8,4,19,19,1,Matches
524,Tawanda Chirewa,zw ZIM,"MF,FW",Wolves,eng Premier League,19,2003,1.6,7,3,3,3,1,2,3,66.7,1,0,0,0,1,8,0,0,Matches
525,Pedro Chirivella,es ESP,MF,Nantes,fr Ligue 1,26,1997,28.8,50,28,20,29,1,30,76,39.5,46,22,5,17,31,81,28,0,Matches
526,Leon Chiwome,eng ENG,FW,Wolves,eng Premier League,17,2006,1.9,2,1,0,1,1,1,2,50.0,1,3,1,2,0,2,2,0,Matches
527,Tahith Chong,cw CUW,"MF,FW",Luton Town,eng Premier League,23,1999,22.0,36,22,19,13,4,15,33,45.5,18,30,6,24,8,44,11,1,Matches
528,Joris Chotard,fr FRA,MF,Montpellier,fr Ligue 1,21,2001,28.7,81,52,45,25,11,48,96,50.0,48,47,21,26,44,125,60,0,Matches
529,Andreas Christensen,dk DEN,"DF,MF",Barcelona,es La Liga,27,1996,22.0,23,14,7,14,2,16,28,57.1,12,23,10,13,21,44,41,0,Matches
530,Jacob Christensen,dk DEN,MF,Köln,de Bundesliga,22,2001,2.4,10,6,7,3,0,4,7,57.1,3,8,2,6,4,14,4,0,Matches
531,Oliver Christensen,dk DEN,GK,Fiorentina,it Serie A,24,1999,4.0,0,0,0,0,0,0,0,,0,0,0,0,0,0,1,0,Matches
532,Ryan Christie,sct SCO,MF,Bournemouth,eng Premier League,28,1995,32.3,86,44,34,35,17,39,92,42.4,53,52,11,41,52,138,53,1,Matches
533,Carney Chukwuemeka,eng ENG,"MF,FW",Chelsea,eng Premier League,19,2003,2.5,6,4,3,3,0,1,3,33.3,2,1,1,0,0,6,1,0,Matches
534,Samuel Chukwueze,ng NGA,FW,Milan,it Serie A,24,1999,11.3,18,7,11,5,2,9,17,52.9,8,3,1,2,6,24,3,0,Matches
535,Chumi,es ESP,DF,Almería,es La Liga,24,1999,27.0,34,22,22,12,0,16,26,61.5,10,38,23,15,14,48,107,3,Matches
536,Víctor Chust,es ESP,DF,Cádiz,es La Liga,23,2000,20.7,29,18,23,5,1,18,32,56.3,14,27,21,6,11,40,92,1,Matches
537,Pathé Ciss,sn SEN,MF,Rayo Vallecano,es La Liga,29,1994,18.5,44,24,16,26,2,16,29,55.2,13,27,10,17,30,74,54,0,Matches
538,Alphadjo Cissè,it ITA,FW,Hellas Verona,it Serie A,16,2006,0.1,0,0,0,0,0,0,0,,0,0,0,0,0,0,0,0,Matches
539,Djaoui Cissé,fr FRA,MF,Rennes,fr Ligue 1,19,2004,0.0,0,0,0,0,0,0,0,,0,0,0,0,0,0,0,0,Matches
540,Ibrahim Cissoko,nl NED,"FW,MF",Toulouse,fr Ligue 1,20,2003,2.7,4,3,3,1,0,1,3,33.3,2,3,0,3,1,5,0,0,Matches
541,Giorgio Cittadini,it ITA,DF,Monza,it Serie A,21,2002,0.2,1,1,1,0,0,1,1,100.0,0,1,1,0,0,1,0,0,Matches
542,Giorgio Cittadini,it ITA,DF,Genoa,it Serie A,21,2002,1.2,5,4,4,1,0,3,3,100.0,0,1,0,1,3,8,5,0,Matches
543,Patrick Ciurria,it ITA,"DF,MF",Monza,it Serie A,28,1995,17.8,30,18,13,13,4,13,21,61.9,8,20,5,15,9,39,28,0,Matches
544,Bobby Clark,eng ENG,MF,Liverpool,eng Premier League,18,2005,1.0,2,1,1,1,0,1,5,20.0,4,6,2,4,1,3,1,0,Matches
545,Jordan Clark,eng ENG,MF,Luton Town,eng Premier League,29,1993,14.5,30,17,14,11,5,11,39,28.2,28,24,3,21,11,41,15,1,Matches
546,Alexis Claude-Maurice,fr FRA,MF,Nice,fr Ligue 1,25,1998,5.6,12,5,3,6,3,1,5,20.0,4,4,1,3,5,17,7,0,Matches
547,Jonathan Clauss,fr FRA,DF,Marseille,fr Ligue 1,30,1992,23.0,47,20,22,19,6,26,49,53.1,23,17,3,14,36,83,46,0,Matches
548,Silvi Clúa,es ESP,MF,Girona,es La Liga,18,2005,0.0,2,0,2,0,0,2,2,100.0,0,1,0,1,0,2,0,0,Matches
549,Nathaniel Clyne,eng ENG,DF,Crystal Palace,eng Premier League,32,1991,14.9,24,15,11,11,2,14,21,66.7,7,18,6,12,10,34,33,0,Matches
550,Marcus Coco,fr FRA,"DF,FW",Nantes,fr Ligue 1,27,1996,16.5,43,26,29,10,4,28,60,46.7,32,19,1,18,21,64,38,0,Matches
551,Saúl Coco,gq EQG,DF,Las Palmas,es La Liga,24,1999,25.5,32,19,25,7,0,11,18,61.1,7,27,15,12,20,52,120,3,Matches
552,Séamus Coleman,ie IRL,DF,Everton,eng Premier League,34,1988,7.4,17,14,10,3,4,11,16,68.8,5,12,4,8,7,24,26,1,Matches
553,Maxime Colin,fr FRA,DF,Metz,fr Ligue 1,31,1991,20.4,39,23,25,7,7,16,29,55.2,13,22,7,15,20,59,71,0,Matches
554,Nathan Collins,ie IRL,DF,Brentford,eng Premier League,22,2001,29.5,38,20,24,12,2,19,29,65.5,10,46,30,16,44,82,141,4,Matches
555,Nnamdi Collins,de GER,DF,Eint Frankfurt,de Bundesliga,19,2004,1.0,0,0,0,0,0,0,0,,0,0,0,0,2,2,4,0,Matches
556,Lorenzo Colombo,it ITA,FW,Monza,it Serie A,21,2002,15.1,17,12,3,9,5,8,14,57.1,6,18,5,13,0,17,14,0,Matches
557,Andrea Colpani,it ITA,"MF,FW",Monza,it Serie A,24,1999,29.5,25,15,6,13,6,11,20,55.0,9,11,4,7,14,39,14,0,Matches
558,Levi Colwill,eng ENG,DF,Chelsea,eng Premier League,20,2003,20.0,48,30,26,17,5,26,34,76.5,8,28,10,18,26,74,66,0,Matches
559,Kingsley Coman,fr FRA,FW,Bayern Munich,de Bundesliga,27,1996,12.4,12,7,5,3,4,9,17,52.9,8,15,1,14,2,14,5,0,Matches
560,Eray Cömert,ch SUI,DF,Nantes,fr Ligue 1,25,1998,22.2,42,28,28,13,1,28,38,73.7,10,35,18,17,36,78,77,1,Matches
561,Santi Comesaña,es ESP,MF,Villarreal,es La Liga,26,1996,18.4,44,26,15,21,8,19,38,50.0,19,33,9,24,22,66,27,1,Matches
562,Pietro Comuzzo,it ITA,"DF,FW",Fiorentina,it Serie A,18,2005,0.5,1,1,1,0,0,1,1,100.0,0,1,0,1,1,2,2,0,Matches
563,Alois Confais,fr FRA,"MF,FW",Le Havre,fr Ligue 1,26,1996,0.1,2,2,1,1,0,1,1,100.0,0,0,0,0,0,2,0,0,Matches
564,Andrea Consigli,it ITA,GK,Sassuolo,it Serie A,36,1987,35.0,0,0,0,0,0,0,0,,0,1,0,1,1,1,19,1,Matches
565,Bambasé Conté,de GER,"MF,FW",Hoffenheim,de Bundesliga,20,2003,0.5,3,3,2,0,1,1,1,100.0,0,0,0,0,0,3,0,0,Matches
566,Nikita Contini Baranovsky,it ITA,GK,Napoli,it Serie A,27,1996,0.2,0,0,0,0,0,0,0,,0,0,0,0,0,0,1,0,Matches
567,Lewis Cook,eng ENG,MF,Bournemouth,eng Premier League,26,1997,31.0,61,41,24,30,7,34,63,54.0,29,32,11,21,65,126,46,1,Matches
568,Copete,es ESP,DF,Mallorca,es La Liga,23,1999,14.8,45,27,27,17,1,30,43,69.8,13,12,6,6,32,77,47,1,Matches
569,Diego Coppola,it ITA,DF,Hellas Verona,it Serie A,19,2003,18.2,36,22,25,9,2,20,33,60.6,13,26,9,17,27,63,89,1,Matches
570,Francis Coquelin,fr FRA,MF,Villarreal,es La Liga,32,1991,10.1,20,12,8,10,2,5,13,38.5,8,14,4,10,16,36,15,0,Matches
571,Tommaso Corazza,it ITA,DF,Bologna,it Serie A,19,2004,2.2,10,4,9,1,0,4,9,44.4,5,2,0,2,5,15,3,0,Matches
572,Theo Corbeanu,ca CAN,"MF,FW",Granada,es La Liga,21,2002,2.0,5,2,2,3,0,1,3,33.3,2,3,0,3,3,8,2,0,Matches
573,Jeppe Corfitzen,dk DEN,FW,Lecce,it Serie A,18,2004,0.1,1,0,0,1,0,1,1,100.0,0,0,0,0,0,1,0,0,Matches
574,Jack Cork,eng ENG,MF,Burnley,eng Premier League,34,1989,0.3,2,0,0,2,0,1,3,33.3,2,0,0,0,1,3,1,0,Matches
575,Maxwel Cornet,ci CIV,"MF,FW",West Ham,eng Premier League,26,1996,1.2,3,2,3,0,0,1,5,20.0,4,2,0,2,2,5,1,0,Matches
576,Giacomo Corona,it ITA,FW,Empoli,it Serie A,19,2004,0.1,0,0,0,0,0,0,0,,0,0,0,0,0,0,0,0,Matches
577,Jesús Corona,mx MEX,"MF,DF",Sevilla,es La Liga,30,1993,0.2,0,0,0,0,0,0,0,,0,0,0,0,1,1,0,0,Matches
578,Ángel Correa,ar ARG,"FW,MF",Atlético Madrid,es La Liga,28,1995,17.0,22,15,3,11,8,5,17,29.4,12,13,0,13,2,24,6,0,Matches
579,Joaquín Correa,ar ARG,"FW,MF",Marseille,fr Ligue 1,28,1994,4.8,7,5,4,2,1,0,8,0.0,8,2,0,2,1,8,1,0,Matches
580,Thierry Correia,pt POR,DF,Valencia,es La Liga,24,1999,23.9,63,35,39,20,4,28,49,57.1,21,39,16,23,33,96,61,0,Matches
581,Oscar Cortés,co COL,"FW,MF",Lens,fr Ligue 1,19,2003,0.5,0,0,0,0,0,0,0,,0,1,0,1,0,0,0,0,Matches
582,Danny da Costa,de GER,DF,Mainz 05,de Bundesliga,30,1993,9.2,18,9,9,7,2,9,19,47.4,10,17,4,13,16,34,24,0,Matches
583,David Costa,pt POR,MF,Lens,fr Ligue 1,22,2001,16.6,18,10,5,12,1,10,23,43.5,13,21,4,17,16,34,8,1,Matches
584,Jaume Costa,es ESP,DF,Mallorca,es La Liga,35,1988,18.7,38,22,23,10,5,18,29,62.1,11,14,4,10,16,54,35,0,Matches
585,João Costa,br BRA,"MF,FW",Roma,it Serie A,18,2005,0.2,0,0,0,0,0,0,0,,0,0,0,0,0,0,0,0,Matches
586,Logan Costa,cv CPV,DF,Toulouse,fr Ligue 1,22,2001,29.4,40,24,31,9,0,15,24,62.5,9,42,27,15,23,63,120,1,Matches
587,Samu Costa,pt POR,MF,Mallorca,es La Liga,22,2000,25.6,91,50,40,46,5,46,93,49.5,47,28,14,14,39,130,59,3,Matches
588,Benoît Costil,fr FRA,GK,Salernitana,it Serie A,36,1987,13.0,2,1,1,1,0,2,3,66.7,1,0,0,0,0,2,5,1,Matches
589,Grégoire Coudert,fr FRA,GK,Brest,fr Ligue 1,24,1999,2.0,0,0,0,0,0,0,0,,0,0,0,0,0,0,0,0,Matches
590,Vladimír Coufal,cz CZE,DF,West Ham,eng Premier League,30,1992,34.8,64,41,50,12,2,38,75,50.7,37,49,15,34,43,107,97,0,Matches
591,Lassana Coulibaly,ml MLI,MF,Salernitana,it Serie A,27,1996,23.1,47,32,20,21,6,22,49,44.9,27,23,5,18,16,63,29,0,Matches
592,Mamadou Coulibaly,sn SEN,DF,Salernitana,it Serie A,24,1999,0.0,0,0,0,0,0,0,0,,0,0,0,0,0,0,0,0,Matches
593,Mamadou Coulibaly,fr FRA,MF,Monaco,fr Ligue 1,19,2004,1.3,7,4,2,3,2,3,8,37.5,5,4,0,4,0,7,0,0,Matches
594,Tanguy Coulibaly,fr FRA,"FW,MF",Montpellier,fr Ligue 1,22,2001,6.9,13,11,8,4,1,4,9,44.4,5,11,1,10,2,15,2,0,Matches
595,Thibaut Courtois,be BEL,GK,Real Madrid,es La Liga,31,1992,3.7,1,0,1,0,0,0,0,,0,0,0,0,0,1,0,0,Matches
596,Philippe Coutinho,br BRA,"MF,FW",Aston Villa,eng Premier League,31,1992,0.3,0,0,0,0,0,0,1,0.0,1,0,0,0,0,0,0,0,Matches
597,Yan Couto,br BRA,"DF,FW",Girona,es La Liga,21,2002,24.9,45,34,25,14,6,20,40,50.0,20,14,2,12,10,55,31,1,Matches
598,Nicolas Cozza,fr FRA,DF,Nantes,fr Ligue 1,24,1999,9.9,35,23,23,10,2,17,24,70.8,7,7,0,7,14,49,32,0,Matches
599,Nicolas Cozza,fr FRA,DF,Wolfsburg,de Bundesliga,24,1999,3.1,8,6,4,4,0,2,7,28.6,5,3,0,3,4,12,6,0,Matches
600,Alessio Cragno,it ITA,GK,Sassuolo,it Serie A,29,1994,3.0,0,0,0,0,0,0,0,,0,0,0,0,0,0,3,1,Matches
601,Crespo,pt POR,MF,Rayo Vallecano,es La Liga,26,1996,5.9,16,9,8,6,2,9,17,52.9,8,15,6,9,10,26,7,0,Matches
602,Aaron Cresswell,eng ENG,"DF,FW",West Ham,eng Premier League,33,1989,4.8,3,2,1,1,1,2,3,66.7,1,5,3,2,3,6,7,0,Matches
603,Bryan Cristante,it ITA,"MF,DF",Roma,it Serie A,28,1995,36.5,72,41,33,28,11,28,50,56.0,22,36,6,30,25,97,55,2,Matches
604,Cristian,es ESP,GK,Valencia,es La Liga,25,1998,0.6,0,0,0,0,0,0,0,,0,0,0,0,0,0,0,0,Matches
605,Juan Cruz Armada,es ESP,DF,Osasuna,es La Liga,31,1992,18.5,27,15,16,10,1,17,25,68.0,8,14,7,7,12,39,39,1,Matches
606,Juan Cruz,ar ARG,"FW,MF",Hellas Verona,it Serie A,24,1999,1.2,2,2,0,0,2,0,0,,0,1,0,1,1,3,0,0,Matches
607,Juan Cruz,es ESP,FW,Betis,es La Liga,23,2000,0.8,0,0,0,0,0,0,1,0.0,1,0,0,0,0,0,0,0,Matches
608,Juan Cuadrado,co COL,DF,Inter,it Serie A,35,1988,3.0,4,3,2,2,0,3,5,60.0,2,6,1,5,1,5,2,0,Matches
609,Pau Cubarsí,es ESP,DF,Barcelona,es La Liga,16,2007,17.3,22,14,18,3,1,13,18,72.2,5,20,16,4,12,34,65,0,Matches
610,Marc Cucurella,es ESP,DF,Chelsea,eng Premier League,25,1998,19.8,62,38,36,21,5,34,64,53.1,30,36,13,23,22,84,48,0,Matches
611,Iván Cuéllar,es ESP,GK,Mallorca,es La Liga,39,1984,1.0,0,0,0,0,0,0,0,,0,0,0,0,0,0,0,0,Matches
612,Jorge Cuenca,es ESP,DF,Villarreal,es La Liga,23,1999,21.8,42,29,26,10,6,19,30,63.3,11,26,15,11,21,63,114,0,Matches
613,Josh Cullen,ie IRL,MF,Burnley,eng Premier League,27,1996,22.9,42,29,15,22,5,26,46,56.5,20,31,19,12,15,57,26,1,Matches
614,Matheus Cunha,br BRA,"FW,MF",Wolves,eng Premier League,24,1999,27.1,30,16,8,17,5,13,35,37.1,22,28,7,21,13,43,21,1,Matches
615,Marvin Cuni,al ALB,FW,Frosinone,it Serie A,22,2001,5.9,8,3,1,3,4,3,4,75.0,1,10,1,9,1,9,0,0,Matches
616,Eric Curbelo,es ESP,"DF,MF",Las Palmas,es La Liga,29,1994,1.1,4,3,2,2,0,3,4,75.0,1,3,1,2,2,6,5,1,Matches
617,Sam Curtis,ie IRL,DF,Sheffield Utd,eng Premier League,17,2005,0.3,1,0,1,0,0,1,2,50.0,1,2,0,2,0,1,0,0,Matches
618,Tomáš Čvančara,cz CZE,FW,Gladbach,de Bundesliga,22,2000,10.0,4,3,0,2,2,1,3,33.3,2,5,1,4,2,6,8,0,Matches
619,Danilo D'Ambrosio,it ITA,DF,Monza,it Serie A,34,1988,17.1,57,34,34,20,3,28,41,68.3,13,22,13,9,14,71,31,0,Matches
620,Alberto Dadie,es ESP,MF,Real Sociedad,es La Liga,21,2002,0.3,2,1,2,0,0,0,0,,0,1,0,1,0,2,0,0,Matches
621,Trévis Dago,ci CIV,"FW,MF",Lille,fr Ligue 1,18,2005,0.3,0,0,0,0,0,0,0,,0,0,0,0,1,1,0,0,Matches
622,Finn Dahmen,de GER,GK,Augsburg,de Bundesliga,25,1998,31.0,1,0,1,0,0,1,3,33.3,2,0,0,0,0,1,17,5,Matches
623,Mahmoud Dahoud,de GER,MF,Brighton,eng Premier League,27,1996,5.0,9,4,2,4,3,3,9,33.3,6,4,1,3,1,10,5,0,Matches
624,Mahmoud Dahoud,de GER,MF,Stuttgart,de Bundesliga,27,1996,2.5,5,1,1,4,0,3,7,42.9,4,4,0,4,0,5,1,0,Matches
625,Ameen Al-Dakhil,be BEL,DF,Burnley,eng Premier League,21,2002,11.7,12,5,4,7,1,1,10,10.0,9,13,6,7,12,24,38,2,Matches
626,Thijs Dallinga,nl NED,FW,Toulouse,fr Ligue 1,22,2000,27.9,29,15,6,11,12,9,15,60.0,6,11,4,7,3,32,35,0,Matches
627,Diogo Dalot,pt POR,DF,Manchester Utd,eng Premier League,24,1999,35.3,81,51,58,12,11,51,74,68.9,23,44,16,28,37,118,111,0,Matches
628,Mikkel Damsgaard,dk DEN,MF,Brentford,eng Premier League,23,2000,9.4,29,17,13,9,7,14,40,35.0,26,23,1,22,11,40,10,1,Matches
629,Flavius Daniliuc,at AUT,DF,Salernitana,it Serie A,22,2001,8.3,19,11,12,5,2,9,19,47.4,10,13,4,9,8,27,15,0,Matches
630,Danilo,br BRA,MF,Nott'ham Forest,eng Premier League,22,2001,19.9,36,18,22,12,2,21,46,45.7,25,34,8,26,35,71,42,0,Matches
631,Danilo,br BRA,DF,Juventus,it Serie A,32,1991,27.2,60,36,38,18,4,32,48,66.7,16,34,15,19,37,97,94,0,Matches
632,Arnaut Danjuma,nl NED,"MF,FW",Everton,eng Premier League,26,1997,6.6,6,4,2,3,1,1,4,25.0,3,4,0,4,3,9,0,0,Matches
633,Jayden Danns,eng ENG,FW,Liverpool,eng Premier League,17,2006,0.1,0,0,0,0,0,0,0,,0,0,0,0,0,0,0,0,Matches
634,Kevin Danso,at AUT,DF,Lens,fr Ligue 1,24,1998,29.5,24,14,12,11,1,15,30,50.0,15,43,30,13,23,47,115,1,Matches
635,Dante,br BRA,DF,Nice,fr Ligue 1,39,1983,31.6,62,30,44,16,2,38,52,73.1,14,43,22,21,37,99,77,2,Matches
636,Raimane Daou,km COM,"DF,MF",Marseille,fr Ligue 1,18,2004,0.3,1,1,1,0,0,1,2,50.0,1,0,0,0,0,1,2,0,Matches
637,Mohamed Daramy,dk DEN,"FW,MF",Reims,fr Ligue 1,21,2002,18.3,10,9,4,4,2,6,16,37.5,10,5,1,4,4,14,4,0,Matches
638,Sergi Darder,es ESP,MF,Mallorca,es La Liga,29,1993,24.0,39,26,13,21,5,12,31,38.7,19,20,4,16,16,55,16,0,Matches
639,Achraf Dari,ma MAR,"DF,FW",Brest,fr Ligue 1,24,1999,1.3,1,1,1,0,0,0,2,0.0,2,2,0,2,5,6,9,1,Matches
640,Matteo Darmian,it ITA,DF,Inter,it Serie A,33,1989,26.7,48,22,23,15,10,20,53,37.7,33,27,11,16,13,61,55,0,Matches
641,Lukas Daschner,de GER,"MF,FW",Bochum,de Bundesliga,24,1998,6.0,9,4,2,3,4,4,9,44.4,5,7,0,7,2,11,2,0,Matches
642,Josh Dasilva,eng ENG,"DF,FW",Brentford,eng Premier League,24,1998,0.3,2,1,0,1,1,0,0,,0,0,0,0,0,2,0,0,Matches
643,David Datro Fofana,ci CIV,FW,Burnley,eng Premier League,20,2002,9.8,10,5,3,5,2,3,6,50.0,3,9,3,6,1,11,2,0,Matches
644,David Datro Fofana,ci CIV,"FW,MF",Union Berlin,de Bundesliga,20,2002,7.6,10,7,3,5,2,4,9,44.4,5,4,0,4,0,10,5,0,Matches
645,Juan David Cabal,co COL,DF,Hellas Verona,it Serie A,22,2001,16.6,36,27,19,14,3,18,29,62.1,11,30,9,21,26,62,55,2,Matches
646,Jonathan David,ca CAN,FW,Lille,fr Ligue 1,23,2000,29.2,26,15,6,13,7,8,26,30.8,18,16,0,16,9,35,4,0,Matches
647,Alphonso Davies,ca CAN,DF,Bayern Munich,de Bundesliga,22,2000,22.9,47,24,29,13,5,30,53,56.6,23,30,4,26,26,73,49,1,Matches
648,Ben Davies,wls WAL,DF,Tottenham,eng Premier League,30,1993,12.1,24,17,13,8,3,16,21,76.2,5,17,15,2,10,34,35,0,Matches
649,Tom Davies,eng ENG,MF,Sheffield Utd,eng Premier League,25,1998,2.5,10,5,4,3,3,3,9,33.3,6,2,1,1,3,13,6,1,Matches
650,Keinan Davis,eng ENG,"FW,MF",Udinese,it Serie A,25,1998,2.1,0,0,0,0,0,0,0,,0,0,0,0,0,0,3,0,Matches
651,Paweł Dawidowicz,pl POL,DF,Hellas Verona,it Serie A,28,1995,23.8,53,30,33,18,2,17,29,58.6,12,17,9,8,24,77,114,1,Matches
652,Craig Dawson,eng ENG,DF,Wolves,eng Premier League,33,1990,24.5,30,20,23,6,1,22,34,64.7,12,51,39,12,16,46,120,1,Matches
653,Kevin De Bruyne,be BEL,MF,Manchester City,eng Premier League,32,1991,13.6,14,9,1,5,8,7,20,35.0,13,5,0,5,4,18,4,0,Matches
654,Bobby De Cordova-Reid,jm JAM,FW,Fulham,eng Premier League,30,1993,15.8,22,14,5,15,2,4,16,25.0,12,24,2,22,5,27,14,0,Matches
655,Charles De Ketelaere,be BEL,"FW,MF",Atalanta,it Serie A,22,2001,22.5,33,21,3,12,18,10,20,50.0,10,30,2,28,7,40,6,0,Matches
656,Rodrigo De Paul,ar ARG,MF,Atlético Madrid,es La Liga,29,1994,23.1,31,21,11,14,6,15,38,39.5,23,28,1,27,11,42,15,2,Matches
657,Mattia De Sciglio,it ITA,DF,Juventus,it Serie A,30,1992,0.5,0,0,0,0,0,0,0,,0,1,0,1,1,1,2,0,Matches
658,Lorenzo De Silvestri,it ITA,DF,Bologna,it Serie A,35,1988,7.5,10,8,5,2,3,4,7,57.1,3,9,4,5,6,16,27,0,Matches
659,Thibault De Smet,be BEL,DF,Reims,fr Ligue 1,25,1998,20.3,56,35,36,16,4,33,59,55.9,26,25,5,20,21,77,51,1,Matches
660,Koni De Winter,be BEL,DF,Genoa,it Serie A,21,2002,26.4,44,25,26,13,5,21,31,67.7,10,30,10,20,21,65,78,0,Matches
661,Grégoire Defrel,mq MTQ,"FW,MF",Sassuolo,it Serie A,32,1991,8.4,17,8,7,5,5,7,15,46.7,8,10,0,10,3,20,9,0,Matches
662,Alessandro Deiola,it ITA,MF,Cagliari,it Serie A,27,1995,17.9,33,19,13,16,4,18,47,38.3,29,16,6,10,9,42,37,0,Matches
663,Romain Del Castillo,fr FRA,FW,Brest,fr Ligue 1,27,1996,27.7,46,29,14,18,14,18,70,25.7,52,33,1,32,9,55,8,0,Matches
664,Thomas Delaine,fr FRA,"DF,MF",Strasbourg,fr Ligue 1,31,1992,22.7,38,19,29,8,1,20,42,47.6,22,18,2,16,17,55,51,0,Matches
665,Sacha Delaye,fr FRA,"MF,FW",Montpellier,fr Ligue 1,21,2002,1.4,7,2,2,2,3,1,6,16.7,5,2,0,2,0,7,1,0,Matches
666,Hannes Delcroix,be BEL,DF,Burnley,eng Premier League,24,1999,6.5,10,6,6,4,0,3,4,75.0,1,9,3,6,9,19,26,0,Matches
667,Alessandro Dellavalle,it ITA,DF,Torino,it Serie A,19,2004,0.2,0,0,0,0,0,0,0,,0,1,1,0,1,1,0,0,Matches
668,Olivier Deman,be BEL,DF,Werder Bremen,de Bundesliga,23,2000,15.2,28,15,21,4,3,18,38,47.4,20,24,8,16,14,42,49,1,Matches
669,Karamoko Dembélé,eng ENG,"MF,FW",Brest,fr Ligue 1,20,2003,0.2,0,0,0,0,0,0,0,,0,0,0,0,0,0,0,0,Matches
670,Ousmane Dembélé,fr FRA,"MF,FW",Paris S-G,fr Ligue 1,26,1997,16.7,19,14,2,7,10,6,13,46.2,7,11,0,11,5,24,4,1,Matches
671,Jessy Deminguet,fr FRA,"MF,FW",Strasbourg,fr Ligue 1,25,1998,7.7,14,9,6,8,0,6,18,33.3,12,8,0,8,9,23,5,1,Matches
672,Ermedin Demirović,ba BIH,"FW,MF",Augsburg,de Bundesliga,25,1998,31.9,24,14,5,16,3,12,40,30.0,28,28,2,26,11,35,26,0,Matches
673,Diego Demme,de GER,MF,Napoli,it Serie A,31,1991,0.8,1,1,0,1,0,0,1,0.0,1,0,0,0,0,1,0,0,Matches
674,Sepp van den Berg,nl NED,DF,Mainz 05,de Bundesliga,21,2001,31.5,38,23,20,15,3,15,26,57.7,11,66,36,30,43,81,159,2,Matches
675,Leander Dendoncker,be BEL,MF,Aston Villa,eng Premier League,28,1995,1.3,6,4,3,2,1,4,5,80.0,1,5,2,3,2,8,3,1,Matches
676,Leander Dendoncker,be BEL,MF,Napoli,it Serie A,28,1995,0.3,0,0,0,0,0,0,0,,0,1,1,0,0,0,0,0,Matches
677,Rémy Descamps,fr FRA,GK,Nantes,fr Ligue 1,27,1996,6.0,0,0,0,0,0,0,0,,0,0,0,0,0,0,7,0,Matches
678,Mikkel Desler,dk DEN,DF,Toulouse,fr Ligue 1,28,1995,17.2,18,12,8,7,3,9,17,52.9,8,32,13,19,19,37,38,0,Matches
679,Arthur Desmas,fr FRA,GK,Le Havre,fr Ligue 1,29,1994,33.0,0,0,0,0,0,0,2,0.0,2,0,0,0,0,0,13,1,Matches
680,Mattia Destro,it ITA,"FW,MF",Empoli,it Serie A,32,1991,4.1,2,1,0,2,0,1,1,100.0,0,4,0,4,2,4,3,0,Matches
681,Samuele Di Benedetto,de GER,MF,Stuttgart,de Bundesliga,18,2005,0.1,0,0,0,0,0,0,0,,0,0,0,0,1,1,0,0,Matches
682,Federico Di Francesco,it ITA,"FW,MF",Lecce,it Serie A,29,1994,0.2,1,0,0,1,0,0,0,,0,0,0,0,0,1,0,0,Matches
683,Raffaele Di Gennaro,it ITA,GK,Inter,it Serie A,29,1993,0.3,0,0,0,0,0,0,0,,0,0,0,0,0,0,0,0,Matches
684,Michele Di Gregorio,it ITA,GK,Monza,it Serie A,26,1997,31.9,1,0,1,0,0,1,4,25.0,3,1,0,1,1,2,10,2,Matches
685,Giovanni Di Lorenzo,it ITA,DF,Napoli,it Serie A,29,1993,35.9,58,36,26,26,6,32,68,47.1,36,43,16,27,24,82,45,0,Matches
686,Alessandro Di Pardo,it ITA,"DF,MF",Cagliari,it Serie A,24,1999,4.0,4,1,3,0,1,0,3,0.0,3,9,2,7,5,9,7,0,Matches
687,Boulaye Dia,sn SEN,"FW,MF",Salernitana,it Serie A,26,1996,12.7,4,2,2,2,0,1,3,33.3,2,5,0,5,3,7,7,0,Matches
688,Moussa Diaby,fr FRA,"FW,MF",Aston Villa,eng Premier League,24,1999,24.2,12,5,5,4,3,4,22,18.2,18,8,1,7,9,21,6,0,Matches
689,Lamine Diack,sn SEN,MF,Nantes,fr Ligue 1,22,2000,0.0,0,0,0,0,0,0,0,,0,0,0,0,0,0,0,0,Matches
690,Mouctar Diakhaby,gn GUI,"DF,MF",Valencia,es La Liga,26,1996,11.9,18,11,9,9,0,11,13,84.6,2,17,7,10,11,29,62,0,Matches
691,Mamadou Diakhon,fr FRA,"FW,MF",Reims,fr Ligue 1,17,2005,2.3,5,3,2,1,2,3,9,33.3,6,1,0,1,1,6,1,0,Matches
692,Bafodé Diakité,fr FRA,DF,Lille,fr Ligue 1,22,2001,18.8,29,20,12,15,2,24,32,75.0,8,16,8,8,21,50,49,1,Matches
693,Ibrahim Diakité,gn GUI,DF,Reims,fr Ligue 1,19,2003,1.2,1,0,0,1,0,0,1,0.0,1,3,0,3,2,3,5,0,Matches
694,Moussa Diakité,ml MLI,MF,Cádiz,es La Liga,19,2003,0.0,0,0,0,0,0,0,0,,0,0,0,0,0,0,0,0,Matches
695,Oumar Diakité,ci CIV,FW,Reims,fr Ligue 1,19,2003,17.6,25,12,10,9,6,7,21,33.3,14,13,0,13,7,32,7,0,Matches
696,Amad Diallo,ci CIV,"FW,MF",Manchester Utd,eng Premier League,21,2002,4.3,10,3,1,6,3,3,7,42.9,4,3,1,2,1,11,6,0,Matches
697,Amadou Diallo,eng ENG,MF,Newcastle Utd,eng Premier League,20,2003,0.0,0,0,0,0,0,0,0,,0,0,0,0,0,0,0,0,Matches
698,Assane Diao,sn SEN,FW,Betis,es La Liga,17,2005,11.6,20,12,5,9,6,6,17,35.3,11,22,4,18,7,27,7,0,Matches
699,Habib Diarra,sn SEN,"MF,FW",Strasbourg,fr Ligue 1,19,2004,25.6,30,23,8,20,2,9,33,27.3,24,23,4,19,17,47,15,0,Matches
700,Moussa Diarra,ml MLI,DF,Toulouse,fr Ligue 1,22,2000,15.5,32,12,16,15,1,13,27,48.1,14,30,14,16,20,52,43,0,Matches
701,Rúben Dias,pt POR,DF,Manchester City,eng Premier League,26,1997,28.4,39,20,14,21,4,19,26,73.1,7,32,17,15,30,69,77,0,Matches
702,Krépin Diatta,sn SEN,"DF,FW",Monaco,fr Ligue 1,24,1999,13.4,37,20,17,16,4,27,49,55.1,22,17,2,15,16,53,22,0,Matches
703,Mory Diaw,sn SEN,GK,Clermont Foot,fr Ligue 1,30,1993,30.0,1,1,1,0,0,1,2,50.0,1,0,0,0,1,2,13,5,Matches
704,Mahamadou Diawara,fr FRA,MF,Lyon,fr Ligue 1,18,2005,4.0,9,6,4,5,0,3,11,27.3,8,4,1,3,4,13,4,0,Matches
705,Brahim Díaz,ma MAR,"FW,MF",Real Madrid,es La Liga,23,1999,17.2,29,19,4,16,9,6,13,46.2,7,16,1,15,5,34,2,0,Matches
706,Luis Díaz,co COL,FW,Liverpool,eng Premier League,26,1997,29.2,35,25,5,17,13,7,30,23.3,23,15,0,15,3,38,8,0,Matches
707,Víctor Díaz,es ESP,"DF,MF",Granada,es La Liga,35,1988,1.8,5,3,2,3,0,1,3,33.3,2,1,0,1,1,6,8,0,Matches
708,Famara Diedhiou,sn SEN,"FW,MF",Granada,es La Liga,30,1992,1.0,1,1,0,1,0,0,1,0.0,1,0,0,0,0,1,2,0,Matches
709,Justin Diehl,de GER,"FW,MF",Köln,de Bundesliga,18,2004,1.9,0,0,0,0,0,0,0,,0,1,1,0,0,0,0,1,Matches
710,Bamba Dieng,sn SEN,FW,Lorient,fr Ligue 1,23,2000,6.1,3,3,0,3,0,1,3,33.3,2,3,0,3,0,3,7,0,Matches
711,Eric Dier,eng ENG,DF,Tottenham,eng Premier League,29,1994,2.2,2,1,2,0,0,2,2,100.0,0,3,3,0,2,4,12,0,Matches
712,Eric Dier,eng ENG,DF,Bayern Munich,de Bundesliga,29,1994,13.0,11,8,5,5,1,5,6,83.3,1,20,12,8,10,21,48,1,Matches
713,Guillaume Dietsch,fr FRA,GK,Metz,fr Ligue 1,22,2001,0.8,0,0,0,0,0,0,0,,0,0,0,0,0,0,0,0,Matches
714,Florian Dietz,de GER,"FW,MF",Köln,de Bundesliga,24,1998,0.8,0,0,0,0,0,0,0,,0,1,0,1,0,0,0,0,Matches
715,Lucas Digne,fr FRA,DF,Aston Villa,eng Premier League,30,1993,26.8,47,19,35,9,3,25,44,56.8,19,20,2,18,26,73,67,0,Matches
716,Federico Dimarco,it ITA,DF,Inter,it Serie A,25,1997,23.1,42,25,19,14,9,17,35,48.6,18,18,3,15,9,51,34,1,Matches
717,Stole Dimitrievski,mk MKD,GK,Rayo Vallecano,es La Liga,29,1993,37.0,1,1,1,0,0,1,1,100.0,0,0,0,0,0,1,17,3,Matches
718,Junior Dina Ebimbe,fr FRA,"MF,DF",Eint Frankfurt,de Bundesliga,22,2000,21.7,44,29,15,17,12,18,41,43.9,23,28,7,21,9,53,39,1,Matches
719,Eren Dinkçi,de GER,"FW,MF",Heidenheim,de Bundesliga,21,2001,29.4,32,18,16,13,3,19,48,39.6,29,40,4,36,12,44,21,0,Matches
720,Sinaly Diomande,ci CIV,DF,Lyon,fr Ligue 1,22,2001,9.9,10,4,5,3,2,9,16,56.3,7,12,9,3,15,25,26,1,Matches
721,Edan Diop,fr FRA,"MF,DF",Monaco,fr Ligue 1,18,2004,1.8,10,8,6,3,1,7,9,77.8,2,3,0,3,1,11,5,0,Matches
722,Issa Diop,fr FRA,DF,Fulham,eng Premier League,26,1997,15.8,30,16,23,5,2,15,20,75.0,5,28,19,9,17,47,80,1,Matches
723,Sofiane Diop,fr FRA,FW,Nice,fr Ligue 1,23,2000,5.5,8,6,3,4,1,4,10,40.0,6,4,0,4,3,11,3,0,Matches
724,Andy Diouf,fr FRA,MF,Lens,fr Ligue 1,20,2003,14.6,28,19,12,11,5,14,22,63.6,8,13,3,10,3,31,5,1,Matches
725,Yehvann Diouf,sn SEN,GK,Reims,fr Ligue 1,23,1999,34.0,0,0,0,0,0,0,1,0.0,1,0,0,0,1,1,19,3,Matches
726,Axel Disasi,fr FRA,DF,Chelsea,eng Premier League,25,1998,28.7,33,19,20,10,3,23,30,76.7,7,26,19,7,18,51,102,2,Matches
727,Tiago Djaló,pt POR,DF,Juventus,it Serie A,23,2000,0.2,0,0,0,0,0,0,0,,0,1,0,1,0,0,1,0,Matches
728,Chaim El Djebali,tn TUN,MF,Lyon,fr Ligue 1,19,2004,0.1,0,0,0,0,0,0,0,,0,0,0,0,0,0,0,0,Matches
729,Djené,tg TOG,"DF,MF",Getafe,es La Liga,31,1991,27.6,34,19,18,13,3,15,26,57.7,11,31,15,16,23,57,70,0,Matches
730,Koffi Djidji,ci CIV,DF,Torino,it Serie A,30,1992,8.4,14,9,9,5,0,3,4,75.0,1,10,5,5,10,24,20,0,Matches
731,Berat Djimsiti,al ALB,DF,Atalanta,it Serie A,30,1993,31.5,42,24,29,12,1,19,31,61.3,12,53,33,20,57,99,100,0,Matches
732,Marko Dmitrović,rs SRB,GK,Sevilla,es La Liga,31,1992,13.0,1,1,1,0,0,1,2,50.0,1,0,0,0,1,2,5,0,Matches
733,Ben Doak,sct SCO,FW,Liverpool,eng Premier League,17,2005,0.2,0,0,0,0,0,0,0,,0,0,0,0,0,0,0,0,Matches
734,Ritsu Doan,jp JPN,"DF,MF",Freiburg,de Bundesliga,25,1998,25.0,50,27,21,19,10,21,36,58.3,15,30,3,27,9,59,29,0,Matches
735,Lewis Dobbin,eng ENG,MF,Everton,eng Premier League,20,2003,2.6,9,7,3,5,1,5,9,55.6,4,5,1,4,1,10,0,0,Matches
736,Dodô,br BRA,DF,Fiorentina,it Serie A,24,1998,5.8,5,3,1,4,0,2,5,40.0,3,2,0,2,5,10,11,0,Matches
737,Danilho Doekhi,nl NED,DF,Union Berlin,de Bundesliga,25,1998,24.0,34,23,18,16,0,15,21,71.4,6,46,25,21,38,72,111,1,Matches
738,Matt Doherty,ie IRL,"DF,MF",Wolves,eng Premier League,31,1992,12.8,31,18,17,10,4,12,23,52.2,11,15,5,10,7,38,47,0,Matches
739,Josh Doig,sct SCO,DF,Hellas Verona,it Serie A,21,2002,9.2,16,9,9,7,0,13,17,76.5,4,12,3,9,4,20,17,1,Matches
740,Josh Doig,sct SCO,DF,Sassuolo,it Serie A,21,2002,14.9,25,17,16,9,0,15,27,55.6,12,31,10,21,16,41,38,0,Matches
741,Jeremy Doku,be BEL,"FW,MF",Manchester City,eng Premier League,21,2002,17.7,39,22,13,12,14,9,20,45.0,11,14,0,14,9,48,5,0,Matches
742,Jeremy Doku,be BEL,FW,Rennes,fr Ligue 1,21,2002,1.2,2,2,1,0,1,1,1,100.0,0,0,0,0,0,2,0,0,Matches
743,Jaume Doménech,es ESP,GK,Valencia,es La Liga,32,1990,0.9,0,0,0,0,0,0,0,,0,0,0,0,0,0,0,0,Matches
744,Carlos Dominguez,es ESP,DF,Celta Vigo,es La Liga,22,2001,17.6,33,21,17,9,7,23,37,62.2,14,24,12,12,22,55,78,0,Matches
745,Mario Dominguez,es ESP,FW,Valencia,es La Liga,19,2004,0.3,0,0,0,0,0,0,0,,0,0,0,0,0,0,0,0,Matches
746,Nicolás Domínguez,ar ARG,"MF,FW",Nott'ham Forest,eng Premier League,25,1998,16.6,63,34,35,27,1,23,48,47.9,25,31,5,26,18,81,24,0,Matches
747,Nicolás Domínguez,ar ARG,MF,Bologna,it Serie A,25,1998,1.1,1,0,1,0,0,0,2,0.0,2,3,0,3,0,1,2,0,Matches
748,Giulio Donati,it ITA,DF,Monza,it Serie A,33,1990,0.4,0,0,0,0,0,0,0,,0,0,0,0,0,0,1,1,Matches
749,Jamie Donley,nir NIR,FW,Tottenham,eng Premier League,18,2005,0.0,0,0,0,0,0,0,0,,0,0,0,0,0,0,3,0,Matches
750,Gianluigi Donnarumma,it ITA,GK,Paris S-G,fr Ligue 1,24,1999,24.1,0,0,0,0,0,0,0,,0,0,0,0,1,1,9,4,Matches
751,Patrick Dorgu,dk DEN,"DF,MF",Lecce,it Serie A,18,2004,17.4,43,22,22,17,4,22,34,64.7,12,16,5,11,9,52,45,2,Matches
752,Niklas Dorsch,de GER,MF,Augsburg,de Bundesliga,25,1998,15.4,35,24,13,21,1,13,33,39.4,20,15,9,6,16,51,27,0,Matches
753,Alberto Dossena,it ITA,DF,Cagliari,it Serie A,24,1998,33.1,55,35,43,12,0,32,48,66.7,16,50,27,23,45,100,172,2,Matches
754,Carlos Dotor,es ESP,MF,Celta Vigo,es La Liga,22,2001,7.9,14,7,3,8,3,4,13,30.8,9,12,2,10,4,18,4,0,Matches
755,Abdoulaye Doucouré,ml MLI,"FW,MF",Everton,eng Premier League,30,1993,29.2,43,27,20,14,9,18,46,39.1,28,23,3,20,15,58,19,0,Matches
756,Cheick Doucouré,ml MLI,MF,Crystal Palace,eng Premier League,23,2000,10.2,34,17,15,13,6,18,30,60.0,12,13,2,11,20,54,12,0,Matches
757,Siriné Doucouré,ml MLI,FW,Lorient,fr Ligue 1,21,2002,4.7,8,6,0,4,4,3,3,100.0,0,4,0,4,1,9,6,0,Matches
758,Désiré Doué,fr FRA,"MF,FW",Rennes,fr Ligue 1,18,2005,18.1,32,18,11,14,7,10,33,30.3,23,30,1,29,14,46,8,0,Matches
759,Guela Doué,ci CIV,DF,Rennes,fr Ligue 1,20,2002,13.7,28,21,14,12,2,22,32,68.8,10,12,1,11,15,43,65,1,Matches
760,Alfie Doughty,eng ENG,DF,Luton Town,eng Premier League,23,1999,32.5,63,40,29,18,16,37,82,45.1,45,51,9,42,31,94,43,4,Matches
761,Douglas,br BRA,MF,Nantes,fr Ligue 1,26,1997,19.7,70,42,34,30,6,30,59,50.8,29,22,8,14,26,96,30,0,Matches
762,Ismaël Doukouré,fr FRA,"MF,DF",Strasbourg,fr Ligue 1,20,2003,18.4,23,16,7,14,2,13,21,61.9,8,19,7,12,19,42,29,2,Matches
763,Kamory Doumbia,ml MLI,MF,Brest,fr Ligue 1,20,2003,9.8,28,18,8,10,10,10,29,34.5,19,14,0,14,9,37,6,0,Matches
764,Anastasios Douvikas,gr GRE,FW,Celta Vigo,es La Liga,23,1999,10.1,15,7,2,6,7,3,8,37.5,5,6,3,3,2,17,9,0,Matches
765,Artem Dovbyk,ua UKR,FW,Girona,es La Liga,26,1997,28.7,4,3,2,1,1,0,2,0.0,2,8,1,7,0,4,17,0,Matches
766,Nikola Dovedan,at AUT,"MF,FW",Heidenheim,de Bundesliga,29,1994,7.3,14,9,2,10,2,5,25,20.0,20,9,0,9,1,15,3,0,Matches
767,Damion Downs,us USA,"FW,MF",Köln,de Bundesliga,19,2004,2.0,1,1,1,0,0,1,2,50.0,1,1,0,1,0,1,1,0,Matches
768,Tommy Doyle,eng ENG,MF,Wolves,eng Premier League,21,2001,13.6,26,13,11,10,5,14,23,60.9,9,22,9,13,12,38,18,0,Matches
769,Radu Drăgușin,ro ROU,DF,Tottenham,eng Premier League,21,2002,4.8,5,3,5,0,0,3,3,100.0,0,5,4,1,8,13,19,0,Matches
770,Radu Drăgușin,ro ROU,DF,Genoa,it Serie A,21,2002,19.0,16,11,9,6,1,8,9,88.9,1,18,12,6,21,37,87,3,Matches
771,Dion Drena Beljo,hr CRO,"FW,MF",Augsburg,de Bundesliga,21,2002,6.5,0,0,0,0,0,0,2,0.0,2,8,1,7,1,1,4,0,Matches
772,Tim Drexler,de GER,DF,Hoffenheim,de Bundesliga,18,2005,6.4,16,9,12,4,0,8,17,47.1,9,12,8,4,8,24,14,0,Matches
773,Domingos Duarte,pt POR,DF,Getafe,es La Liga,28,1995,10.1,7,4,6,0,1,5,7,71.4,2,7,5,2,8,15,27,0,Matches
774,Rubén Duarte,es ESP,DF,Alavés,es La Liga,27,1995,20.9,39,20,21,16,2,21,31,67.7,10,21,6,15,23,62,69,0,Matches
775,Martin Dúbravka,sk SVK,GK,Newcastle Utd,eng Premier League,34,1989,22.1,0,0,0,0,0,0,4,0.0,4,0,0,0,0,0,8,1,Matches
776,Marvin Ducksch,de GER,FW,Werder Bremen,de Bundesliga,29,1994,30.0,8,3,4,3,1,6,14,42.9,8,2,0,2,4,12,25,0,Matches
777,Ondrej Duda,sk SVK,MF,Hellas Verona,it Serie A,28,1994,27.3,59,39,17,35,7,31,52,59.6,21,29,12,17,26,85,21,0,Matches
778,Denzel Dumfries,nl NED,DF,Inter,it Serie A,27,1996,18.2,22,13,9,11,2,9,23,39.1,14,15,6,9,12,34,33,1,Matches
779,Paul Dummett,wls WAL,DF,Newcastle Utd,eng Premier League,31,1991,0.2,1,0,1,0,0,1,1,100.0,0,0,0,0,0,1,1,0,Matches
780,Alfred Duncan,gh GHA,MF,Fiorentina,it Serie A,30,1993,21.0,35,22,13,15,7,15,35,42.9,20,27,5,22,11,46,13,0,Matches
781,Lewis Dunk,eng ENG,DF,Brighton,eng Premier League,31,1991,31.9,27,14,17,9,1,13,36,36.1,23,49,37,12,31,58,90,1,Matches
782,Jáder Durán,co COL,"FW,MF",Aston Villa,eng Premier League,19,2003,5.3,6,5,3,1,2,1,6,16.7,5,6,0,6,1,7,10,0,Matches
783,Julien Duranville,be BEL,"FW,MF",Dortmund,de Bundesliga,17,2006,0.1,1,0,0,1,0,1,1,100.0,0,0,0,0,0,1,0,0,Matches
784,Hugo Duro,es ESP,FW,Valencia,es La Liga,23,1999,33.1,16,8,5,8,3,9,29,31.0,20,24,5,19,5,21,27,0,Matches
785,Jean-Kevin Duverne,ht HAI,DF,Nantes,fr Ligue 1,26,1997,15.0,37,19,16,17,4,18,44,40.9,26,17,5,12,18,55,34,0,Matches
786,Paulo Dybala,ar ARG,"FW,MF",Roma,it Serie A,29,1993,21.8,22,13,3,10,9,2,18,11.1,16,12,0,12,3,25,6,1,Matches
787,Aron Dønnum,no NOR,"FW,MF",Toulouse,fr Ligue 1,25,1998,17.7,16,10,3,8,5,7,22,31.8,15,13,0,13,8,24,16,1,Matches
788,George Earthy,eng ENG,FW,West Ham,eng Premier League,18,2004,0.4,0,0,0,0,0,0,1,0.0,1,0,0,0,1,1,0,0,Matches
789,Simon Ebonog,cm CMR,MF,Le Havre,fr Ligue 1,18,2004,0.2,1,1,0,1,0,1,1,100.0,0,1,1,0,0,1,1,0,Matches
790,Festy Ebosele,ie IRL,DF,Udinese,it Serie A,20,2002,18.9,33,20,23,9,1,21,35,60.0,14,33,2,31,10,43,27,0,Matches
791,Enzo Ebosse,cm CMR,DF,Udinese,it Serie A,24,1999,0.1,1,1,1,0,0,0,1,0.0,1,0,0,0,1,2,0,0,Matches
792,Tyronne Ebuehi,ng NGA,DF,Empoli,it Serie A,27,1995,12.2,14,9,9,5,0,7,11,63.6,4,9,4,5,6,20,27,1,Matches
793,Ederson,br BRA,GK,Manchester City,eng Premier League,29,1993,30.9,0,0,0,0,0,0,1,0.0,1,0,0,0,0,0,10,1,Matches
794,Éderson,br BRA,MF,Atalanta,it Serie A,24,1999,31.9,83,49,38,38,7,44,63,69.8,19,48,8,40,41,124,33,1,Matches
795,Odsonne Édouard,fr FRA,"FW,MF",Crystal Palace,eng Premier League,25,1998,17.3,24,12,8,8,8,4,19,21.1,15,17,1,16,6,30,19,0,Matches
796,John Egan,ie IRL,DF,Sheffield Utd,eng Premier League,30,1992,5.4,6,4,4,2,0,4,11,36.4,7,10,4,6,13,19,39,1,Matches
797,Maximilian Eggestein,de GER,MF,Freiburg,de Bundesliga,26,1996,32.4,49,24,25,19,5,15,36,41.7,21,53,19,34,28,77,40,1,Matches
798,Lilian Egloff,de GER,"MF,DF",Stuttgart,de Bundesliga,20,2002,1.2,4,1,3,1,0,2,4,50.0,2,3,1,2,1,5,0,0,Matches
799,Kingsley Ehizibue,nl NED,DF,Udinese,it Serie A,28,1995,10.6,22,14,16,4,2,11,18,61.1,7,21,3,18,8,30,36,0,Matches
800,Hjalmar Ekdal,se SWE,DF,Burnley,eng Premier League,24,1998,4.9,4,2,2,2,0,2,4,50.0,2,10,5,5,6,10,21,0,Matches
801,Hugo Ekitike,fr FRA,FW,Paris S-G,fr Ligue 1,21,2002,0.1,0,0,0,0,0,0,0,,0,0,0,0,0,0,0,0,Matches
802,Hugo Ekitike,fr FRA,FW,Eint Frankfurt,de Bundesliga,21,2002,8.0,11,7,3,6,2,4,6,66.7,2,10,0,10,2,13,4,0,Matches
803,Emmanuel Ekong,se SWE,FW,Empoli,it Serie A,21,2002,0.1,0,0,0,0,0,0,0,,0,0,0,0,0,0,0,0,Matches
804,Caleb Ekuban,gh GHA,FW,Genoa,it Serie A,29,1994,12.6,8,4,2,4,2,5,9,55.6,4,11,3,8,1,9,7,0,Matches
805,Anthony Elanga,se SWE,"FW,MF",Nott'ham Forest,eng Premier League,21,2002,27.0,33,19,20,6,7,17,37,45.9,20,22,2,20,8,41,20,1,Matches
806,Simon Elisor,fr FRA,FW,Metz,fr Ligue 1,24,1999,8.5,9,2,3,2,4,2,6,33.3,4,6,1,5,0,9,9,0,Matches
807,Harvey Elliott,eng ENG,"MF,FW",Liverpool,eng Premier League,20,2003,15.0,27,17,8,14,5,10,31,32.3,21,27,0,27,6,33,7,0,Matches
808,Elif Elmas,mk MKD,"FW,MF",Napoli,it Serie A,23,1999,3.8,4,3,1,3,0,2,2,100.0,0,2,0,2,2,6,8,0,Matches
809,Elif Elmas,mk MKD,"MF,FW",RB Leipzig,de Bundesliga,23,1999,3.0,8,6,1,6,1,6,8,75.0,2,5,0,5,1,9,2,0,Matches
810,Mohamed Elneny,eg EGY,MF,Arsenal,eng Premier League,31,1992,0.3,0,0,0,0,0,0,1,0.0,1,0,0,0,1,1,0,0,Matches
811,Aritz Elustondo,es ESP,DF,Real Sociedad,es La Liga,29,1994,9.0,11,7,5,4,2,6,14,42.9,8,12,10,2,7,18,26,0,Matches
812,Nico Elvedi,ch SUI,DF,Gladbach,de Bundesliga,26,1996,27.6,33,18,22,10,1,18,24,75.0,6,40,25,15,43,76,150,2,Matches
813,Adri Embarba,es ESP,"FW,MF",Almería,es La Liga,31,1992,27.5,55,37,29,15,11,26,53,49.1,27,37,1,36,15,70,12,0,Matches
814,Breel Embolo,ch SUI,FW,Monaco,fr Ligue 1,26,1997,2.0,3,3,0,2,1,1,4,25.0,3,1,0,1,1,4,2,0,Matches
815,Emanuel Emegha,nl NED,FW,Strasbourg,fr Ligue 1,20,2003,23.1,8,5,2,4,2,4,9,44.4,5,13,3,10,2,10,25,0,Matches
816,Emerson,br BRA,DF,Tottenham,eng Premier League,24,1999,12.9,36,24,23,10,3,21,43,48.8,22,23,10,13,20,56,50,1,Matches
817,Youssef En-Nesyri,ma MAR,FW,Sevilla,es La Liga,26,1997,28.6,10,7,3,4,3,0,10,0.0,10,9,1,8,7,17,29,1,Matches
818,Julio Enciso,py PAR,"MF,FW",Brighton,eng Premier League,19,2004,5.3,6,2,3,2,1,2,7,28.6,5,11,0,11,0,6,3,0,Matches
819,Wataru Endo,jp JPN,MF,Liverpool,eng Premier League,30,1993,19.1,48,28,11,31,6,20,61,32.8,41,24,2,22,20,68,31,3,Matches
820,Arne Engels,be BEL,"MF,DF",Augsburg,de Bundesliga,19,2003,15.6,33,18,15,14,4,12,29,41.4,17,23,1,22,15,48,21,0,Matches
821,Christian Eriksen,dk DEN,MF,Manchester Utd,eng Premier League,31,1992,12.7,18,13,5,10,3,12,33,36.4,21,17,6,11,4,22,13,0,Matches
822,Martin Erlic,hr CRO,DF,Sassuolo,it Serie A,25,1998,29.1,37,22,26,8,3,20,30,66.7,10,31,16,15,28,65,128,1,Matches
823,Gonzalo Escalante,ar ARG,MF,Cádiz,es La Liga,30,1993,18.9,39,24,16,14,9,20,55,36.4,35,23,5,18,26,65,33,2,Matches
824,Aarón Escandell,es ESP,GK,Las Palmas,es La Liga,27,1995,1.7,0,0,0,0,0,0,0,,0,0,0,0,0,0,1,1,Matches
825,Alfonso Espino,uy URU,DF,Rayo Vallecano,es La Liga,31,1992,27.9,67,45,43,22,2,30,82,36.6,52,26,4,22,40,107,63,0,Matches
826,Bernardo Espinosa,co COL,DF,Girona,es La Liga,34,1989,0.0,1,1,1,0,0,1,1,100.0,0,0,0,0,0,1,2,0,Matches
827,Maxime Estève,fr FRA,DF,Burnley,eng Premier League,21,2002,14.5,27,10,15,12,0,18,32,56.3,14,21,10,11,27,54,56,0,Matches
828,Maxime Estève,fr FRA,DF,Montpellier,fr Ligue 1,21,2002,11.1,16,12,11,5,0,10,15,66.7,5,13,9,4,18,34,50,0,Matches
829,Oscar Estupiñan,co COL,FW,Metz,fr Ligue 1,26,1996,2.9,5,4,0,3,2,1,2,50.0,1,2,0,2,0,5,0,0,Matches
830,Pervis Estupiñán,ec ECU,DF,Brighton,eng Premier League,25,1998,13.8,26,13,12,11,3,14,30,46.7,16,14,4,10,21,47,20,0,Matches
831,Karl Etta,cm CMR,FW,Cádiz,es La Liga,19,2003,0.2,1,1,0,1,0,0,0,,0,0,0,0,0,1,0,0,Matches
832,Jonny Evans,nir NIR,DF,Manchester Utd,eng Premier League,35,1988,15.5,22,14,20,2,0,12,21,57.1,9,25,18,7,23,45,76,0,Matches
833,Eberechi Eze,eng ENG,"MF,FW",Crystal Palace,eng Premier League,25,1998,22.8,35,17,4,18,13,15,31,48.4,16,27,2,25,11,46,6,0,Matches
834,Abde Ezzalzouli,ma MAR,"FW,MF",Barcelona,es La Liga,21,2001,0.8,1,1,0,0,1,0,1,0.0,1,1,0,1,0,1,0,0,Matches
835,Abde Ezzalzouli,ma MAR,FW,Betis,es La Liga,21,2001,9.6,17,14,7,5,5,4,14,28.6,10,10,0,10,5,22,5,0,Matches
836,Giovanni Fabbian,it ITA,"MF,FW",Bologna,it Serie A,20,2003,11.7,17,10,9,7,1,7,12,58.3,5,5,2,3,7,24,11,0,Matches
837,Łukasz Fabiański,pl POL,GK,West Ham,eng Premier League,38,1985,8.0,1,0,1,0,0,1,2,50.0,1,0,0,0,1,2,4,0,Matches
838,Nicolò Fagioli,it ITA,MF,Juventus,it Serie A,22,2001,4.9,5,3,1,3,1,3,7,42.9,4,3,0,3,4,9,1,0,Matches
839,Romain Faivre,fr FRA,"MF,FW",Bournemouth,eng Premier League,25,1998,0.5,1,1,0,1,0,0,3,0.0,3,0,0,0,0,1,0,0,Matches
840,Romain Faivre,fr FRA,"MF,FW",Lorient,fr Ligue 1,25,1998,16.1,13,6,5,4,4,6,15,40.0,9,6,1,5,7,20,3,1,Matches
841,Ilhan Fakili,fr FRA,"MF,FW",Clermont Foot,fr Ligue 1,17,2006,1.0,0,0,0,0,0,0,1,0.0,1,1,0,1,1,1,0,0,Matches
842,Radamel Falcao,co COL,"FW,DF",Rayo Vallecano,es La Liga,37,1986,4.5,7,5,1,5,1,1,3,33.3,2,2,0,2,3,10,4,0,Matches
843,Wladimiro Falcone,it ITA,GK,Lecce,it Serie A,28,1995,38.0,0,0,0,0,0,0,0,,0,1,0,1,1,1,21,2,Matches
844,Fali,es ESP,DF,Cádiz,es La Liga,29,1993,28.3,41,26,29,11,1,21,36,58.3,15,38,24,14,27,68,120,0,Matches
845,Davide Faraoni,it ITA,DF,Hellas Verona,it Serie A,31,1991,6.7,13,10,5,6,2,7,10,70.0,3,9,5,4,6,19,21,0,Matches
846,Davide Faraoni,it ITA,DF,Fiorentina,it Serie A,31,1991,4.4,9,4,5,2,2,5,11,45.5,6,3,1,2,5,14,14,0,Matches
847,Ansu Fati,es ESP,"MF,FW",Brighton,eng Premier League,20,2002,5.8,5,3,1,2,2,1,11,9.1,10,8,0,8,3,8,3,0,Matches
848,Ansu Fati,es ESP,"MF,FW",Barcelona,es La Liga,20,2002,0.6,0,0,0,0,0,0,1,0.0,1,0,0,0,0,0,0,0,Matches
849,Khalil Fayad,fr FRA,"FW,MF",Montpellier,fr Ligue 1,19,2004,11.4,28,15,17,7,4,9,22,40.9,13,15,3,12,14,42,6,0,Matches
850,Federico Fazio,ar ARG,DF,Salernitana,it Serie A,36,1987,15.1,18,11,14,4,0,8,14,57.1,6,22,19,3,17,35,99,1,Matches
851,Jacopo Fazzini,it ITA,MF,Empoli,it Serie A,20,2003,13.7,49,25,27,13,9,30,53,56.6,23,21,3,18,12,61,18,0,Matches
852,Nabil Fekir,fr FRA,"MF,FW",Betis,es La Liga,30,1993,11.7,15,10,5,7,3,5,10,50.0,5,9,0,9,7,22,3,0,Matches
853,Felipe,br BRA,DF,Nott'ham Forest,eng Premier League,34,1989,4.2,12,9,9,3,0,9,12,75.0,3,4,1,3,4,16,12,0,Matches
854,Luiz Felipe,it ITA,DF,Betis,es La Liga,26,1997,4.0,7,3,5,2,0,4,5,80.0,1,10,4,6,4,11,16,0,Matches
855,João Félix,pt POR,FW,Barcelona,es La Liga,23,1999,17.1,22,16,9,7,6,8,22,36.4,14,14,1,13,10,32,11,0,Matches
856,Ohis Felix Uduokhai,de GER,DF,Augsburg,de Bundesliga,25,1997,32.5,37,21,18,14,5,16,25,64.0,9,45,35,10,46,83,178,2,Matches
857,Kiko Femenía,es ESP,DF,Villarreal,es La Liga,32,1991,17.6,35,25,19,13,3,19,34,55.9,15,21,6,15,31,66,45,0,Matches
858,Evan Ferguson,ie IRL,FW,Brighton,eng Premier League,18,2004,15.2,14,6,4,7,3,5,14,35.7,9,10,3,7,2,16,8,0,Matches
859,Lewis Ferguson,sct SCO,MF,Bologna,it Serie A,23,1999,30.1,37,21,16,17,4,16,37,43.2,21,25,8,17,17,54,27,1,Matches
860,Bruno Fernandes,pt POR,"MF,FW",Manchester Utd,eng Premier League,28,1994,34.6,68,38,27,25,16,30,88,34.1,58,49,6,43,27,95,50,2,Matches
861,Edimilson Fernandes,ch SUI,DF,Mainz 05,de Bundesliga,27,1996,14.3,25,16,15,9,1,16,24,66.7,8,14,6,8,22,47,52,0,Matches
862,Aitor Fernández,es ESP,GK,Osasuna,es La Liga,32,1991,6.1,0,0,0,0,0,0,1,0.0,1,0,0,0,0,0,5,1,Matches
863,Álex Fernández,es ESP,MF,Cádiz,es La Liga,30,1992,14.3,19,9,10,9,0,11,22,50.0,11,17,5,12,15,34,30,0,Matches
864,Carlos Fernández,es ESP,FW,Real Sociedad,es La Liga,27,1996,4.5,11,7,3,6,2,0,2,0.0,2,4,0,4,0,11,5,0,Matches
865,Enzo Fernández,ar ARG,MF,Chelsea,eng Premier League,22,2001,24.5,50,22,22,18,10,27,65,41.5,38,36,13,23,17,67,28,0,Matches
866,Raúl Fernández,es ESP,GK,Granada,es La Liga,35,1988,3.1,0,0,0,0,0,0,1,0.0,1,0,0,0,0,0,1,2,Matches
867,Valery Fernández,es ESP,"MF,FW",Girona,es La Liga,23,1999,5.6,11,9,4,7,0,6,8,75.0,2,6,1,5,1,12,4,0,Matches
868,Fernando,es ESP,GK,Almería,es La Liga,33,1990,4.0,0,0,0,0,0,0,0,,0,1,0,1,0,0,2,0,Matches
869,Fernando,br BRA,MF,Sevilla,es La Liga,36,1987,5.1,9,8,2,4,3,5,9,55.6,4,2,0,2,7,16,9,0,Matches
870,Ichem Ferrah,fr FRA,FW,Lille,fr Ligue 1,17,2005,0.0,0,0,0,0,0,0,0,,0,0,0,0,0,0,0,0,Matches
871,Andrea Ferraris,it ITA,MF,Monza,it Serie A,20,2003,0.1,1,1,1,0,0,0,0,,0,0,0,0,0,1,0,0,Matches
872,André Ferreira,pt POR,GK,Granada,es La Liga,27,1996,14.9,0,0,0,0,0,0,1,0.0,1,0,0,0,0,0,9,2,Matches
873,João Ferreira,pt POR,DF,Udinese,it Serie A,22,2001,20.2,58,42,36,18,4,34,58,58.6,24,27,6,21,29,87,89,0,Matches
874,Jordan Ferri,fr FRA,MF,Montpellier,fr Ligue 1,31,1992,22.6,36,22,16,17,3,20,67,29.9,47,19,1,18,13,49,23,0,Matches
875,Nacho Ferri,es ESP,"FW,MF",Eint Frankfurt,de Bundesliga,18,2004,0.8,3,3,1,2,0,2,3,66.7,1,0,0,0,0,3,2,0,Matches
876,Rachad Fettal,ma MAR,FW,Almería,es La Liga,18,2005,0.2,1,1,1,0,0,0,0,,0,0,0,0,0,1,0,0,Matches
877,Seydou Fini,it ITA,"DF,FW",Genoa,it Serie A,17,2006,0.4,0,0,0,0,0,0,0,,0,0,0,0,0,0,0,0,Matches
878,Max Finkgräfe,de GER,"DF,FW",Köln,de Bundesliga,19,2004,19.5,65,39,40,25,0,39,74,52.7,35,35,10,25,22,87,39,0,Matches
879,Vincenzo Fiorillo,it ITA,GK,Salernitana,it Serie A,33,1990,4.0,0,0,0,0,0,0,0,,0,0,0,0,0,0,0,1,Matches
880,Kilian Fischer,de GER,"DF,MF",Wolfsburg,de Bundesliga,22,2000,3.2,8,6,4,3,1,2,5,40.0,3,8,1,7,1,9,12,0,Matches
881,John Fleck,sct SCO,"MF,DF",Sheffield Utd,eng Premier League,31,1991,1.0,1,0,0,1,0,0,1,0.0,1,0,0,0,0,1,1,0,Matches
882,Mark Flekken,nl NED,GK,Brentford,eng Premier League,30,1993,36.5,1,1,1,0,0,1,5,20.0,4,1,0,1,0,1,17,1,Matches
883,Alessandro Florenzi,it ITA,DF,Milan,it Serie A,32,1991,19.2,43,21,26,12,5,26,48,54.2,22,16,9,7,20,63,25,1,Matches
884,Phil Foden,eng ENG,"FW,MF",Manchester City,eng Premier League,23,2000,31.7,31,20,11,10,10,13,31,41.9,18,30,0,30,13,44,18,1,Matches
885,Wes Foderingham,eng ENG,GK,Sheffield Utd,eng Premier League,32,1991,29.4,5,3,5,0,0,5,6,83.3,1,0,0,0,0,5,18,6,Matches
886,Malick Fofana,be BEL,FW,Lyon,fr Ligue 1,18,2005,6.2,5,4,3,1,1,4,9,44.4,5,3,0,3,5,10,9,0,Matches
887,Youssouf Fofana,fr FRA,MF,Monaco,fr Ligue 1,24,1999,30.0,61,39,19,36,6,30,66,45.5,36,35,7,28,37,98,31,1,Matches
888,Jonas Föhrenbach,de GER,DF,Heidenheim,de Bundesliga,27,1996,31.0,44,24,24,14,6,19,36,52.8,17,34,19,15,31,75,70,0,Matches
889,Thomas Foket,be BEL,DF,Reims,fr Ligue 1,28,1994,20.4,32,17,21,8,3,20,45,44.4,25,34,12,22,25,57,36,0,Matches
890,Michael Folorunsho,it ITA,"MF,FW",Hellas Verona,it Serie A,25,1998,30.9,50,28,21,22,7,23,57,40.4,34,45,12,33,17,67,44,2,Matches
891,Tiago Fonseca Morais,pt POR,FW,Lille,fr Ligue 1,19,2003,0.5,1,1,0,1,0,0,0,,0,0,0,0,1,2,0,0,Matches
892,Pablo Fornals,es ESP,"MF,FW",West Ham,eng Premier League,27,1996,4.7,10,6,4,3,3,5,16,31.3,11,8,1,7,6,16,7,0,Matches
893,Pablo Fornals,es ESP,"FW,MF",Betis,es La Liga,27,1996,12.8,24,16,8,11,5,12,22,54.5,10,14,0,14,22,46,10,2,Matches
894,Emil Forsberg,se SWE,"MF,FW",RB Leipzig,de Bundesliga,31,1991,5.2,7,3,2,5,0,5,12,41.7,7,7,0,7,0,7,5,0,Matches
895,Omari Forson,eng ENG,FW,Manchester Utd,eng Premier League,19,2004,0.8,2,0,0,2,0,1,1,100.0,0,0,0,0,0,2,0,0,Matches
896,Philipp Förster,de GER,"MF,FW",Bochum,de Bundesliga,28,1995,4.3,9,5,3,4,2,2,6,33.3,4,3,0,3,7,16,3,0,Matches
897,Héctor Fort,es ESP,DF,Barcelona,es La Liga,16,2006,3.5,6,5,5,1,0,4,10,40.0,6,0,0,0,2,8,4,0,Matches
898,Lyle Foster,za RSA,"FW,MF",Burnley,eng Premier League,22,2000,21.1,19,10,5,6,8,6,17,35.3,11,13,3,10,3,22,34,0,Matches
899,Dimitri Foulquier,fr FRA,"DF,MF",Valencia,es La Liga,30,1993,20.5,39,22,22,13,4,18,26,69.2,8,10,1,9,16,55,49,1,Matches
900,Juan Foyth,ar ARG,DF,Villarreal,es La Liga,25,1998,11.8,26,15,18,8,0,12,27,44.4,15,17,4,13,12,38,44,0,Matches
901,Matheus França,br BRA,"MF,FW",Crystal Palace,eng Premier League,19,2004,2.6,3,3,2,1,0,1,7,14.3,6,4,0,4,1,4,1,0,Matches
902,Bartol Franjić,hr CRO,MF,Darmstadt 98,de Bundesliga,23,2000,13.7,15,12,4,10,1,7,28,25.0,21,12,4,8,30,45,29,2,Matches
903,Przemysław Frankowski,pl POL,DF,Lens,fr Ligue 1,28,1995,24.4,60,39,25,26,9,31,74,41.9,43,30,7,23,25,85,36,0,Matches
904,Nathan Fraser,ie IRL,FW,Wolves,eng Premier League,18,2005,2.1,5,2,2,1,2,1,3,33.3,2,2,1,1,1,6,2,0,Matches
905,Davide Frattesi,it ITA,MF,Inter,it Serie A,23,1999,10.6,10,6,3,7,0,4,8,50.0,4,9,3,6,5,15,19,0,Matches
906,Morten Frendrup,dk DEN,MF,Genoa,it Serie A,22,2001,34.9,133,72,47,70,16,55,91,60.4,36,55,14,41,51,184,42,1,Matches
907,Remo Freuler,ch SUI,MF,Bologna,it Serie A,31,1992,29.2,78,50,41,32,5,38,69,55.1,31,37,9,28,36,114,53,2,Matches
908,Marco Friedl,at AUT,DF,Werder Bremen,de Bundesliga,25,1998,24.4,53,32,38,15,0,36,48,75.0,12,45,29,16,35,88,129,0,Matches
909,Marvin Friedrich,de GER,DF,Gladbach,de Bundesliga,27,1995,17.4,23,15,16,6,1,12,20,60.0,8,28,20,8,17,40,87,0,Matches
910,Jeremie Frimpong,nl NED,DF,Leverkusen,de Bundesliga,22,2000,25.0,26,17,12,7,7,8,20,40.0,12,26,0,26,7,33,17,0,Matches
911,Jorge de Frutos,es ESP,"FW,MF",Rayo Vallecano,es La Liga,26,1997,17.2,19,8,5,8,6,7,22,31.8,15,12,0,12,7,26,18,0,Matches
912,Chris Führich,de GER,"FW,MF",Stuttgart,de Bundesliga,25,1998,28.5,30,19,6,14,10,16,37,43.2,21,31,0,31,7,37,7,0,Matches
913,Shiō Fukuda,jp JPN,"FW,MF",Gladbach,de Bundesliga,19,2004,0.4,2,0,1,1,0,1,2,50.0,1,0,0,0,1,3,0,0,Matches
914,Angelo Fulgini,fr FRA,MF,Lens,fr Ligue 1,26,1996,15.3,23,14,6,13,4,11,19,57.9,8,22,1,21,8,31,11,0,Matches
915,Niclas Füllkrug,de GER,FW,Werder Bremen,de Bundesliga,30,1993,2.0,1,1,0,1,0,1,1,100.0,0,2,1,1,0,1,1,0,Matches
916,Niclas Füllkrug,de GER,FW,Dortmund,de Bundesliga,30,1993,24.6,7,2,1,6,0,2,8,25.0,6,17,4,13,2,9,25,0,Matches
917,Gerardo Fusco,it ITA,FW,Salernitana,it Serie A,18,2005,0.2,0,0,0,0,0,0,0,,0,0,0,0,0,0,0,0,Matches
918,Daniel Fuzato,br BRA,GK,Getafe,es La Liga,26,1997,0.1,0,0,0,0,0,0,0,,0,0,0,0,0,0,1,0,Matches
919,Matteo Gabbia,it ITA,DF,Milan,it Serie A,23,1999,14.2,29,20,15,13,1,18,24,75.0,6,11,6,5,10,39,48,0,Matches
920,Matteo Gabbia,it ITA,DF,Villarreal,es La Liga,23,1999,5.3,10,6,4,6,0,5,8,62.5,3,5,2,3,8,18,36,1,Matches
921,Gianluca Gaetano,it ITA,"FW,MF",Cagliari,it Serie A,23,2000,8.3,7,4,0,4,3,2,7,28.6,5,4,0,4,3,10,4,0,Matches
922,Gianluca Gaetano,it ITA,MF,Napoli,it Serie A,23,2000,1.8,4,1,0,4,0,2,4,50.0,2,5,2,3,1,5,4,0,Matches
923,Roberto Gagliardini,it ITA,"MF,DF",Monza,it Serie A,29,1994,26.2,61,30,27,25,9,31,50,62.0,19,30,11,19,31,92,38,0,Matches
924,Cody Gakpo,nl NED,"FW,MF",Liverpool,eng Premier League,24,1999,18.3,27,17,8,14,5,8,25,32.0,17,21,4,17,14,41,7,0,Matches
925,Javi Galán,es ESP,DF,Atlético Madrid,es La Liga,28,1994,1.0,5,4,2,2,1,4,5,80.0,1,1,0,1,1,6,3,0,Matches
926,Javi Galán,es ESP,DF,Real Sociedad,es La Liga,28,1994,11.9,38,22,15,19,4,15,30,50.0,15,24,1,23,14,52,17,1,Matches
927,Iñigo Ruiz de Galarreta,es ESP,MF,Athletic Club,es La Liga,29,1993,23.2,49,31,15,26,8,24,49,49.0,25,18,5,13,12,61,17,0,Matches
928,Pablo Galdames Millán,cl CHI,"MF,DF",Genoa,it Serie A,26,1996,0.1,0,0,0,0,0,0,0,,0,1,0,1,0,0,0,0,Matches
929,Conor Gallagher,eng ENG,MF,Chelsea,eng Premier League,23,2000,34.8,85,52,37,31,17,33,77,42.9,44,50,11,39,43,128,34,0,Matches
930,Antonino Gallo,it ITA,DF,Lecce,it Serie A,23,2000,27.7,43,27,31,11,1,31,49,63.3,18,34,9,25,25,68,67,0,Matches
931,Cristian Gamboa,cr CRC,DF,Bochum,de Bundesliga,33,1989,13.2,24,18,12,11,1,14,33,42.4,19,20,7,13,15,39,34,1,Matches
932,Kévin Gameiro,fr FRA,"FW,MF",Strasbourg,fr Ligue 1,36,1987,15.0,10,10,5,3,2,2,17,11.8,15,9,0,9,3,13,7,0,Matches
933,Idrissa Gana Gueye,sn SEN,MF,Everton,eng Premier League,33,1989,20.9,73,44,32,27,14,29,46,63.0,17,24,7,17,28,101,16,0,Matches
934,Ignatius Ganago,cm CMR,"FW,MF",Nantes,fr Ligue 1,24,1999,2.0,0,0,0,0,0,0,1,0.0,1,1,0,1,1,1,1,0,Matches
935,Aleix García,es ESP,MF,Girona,es La Liga,26,1997,35.5,49,28,17,26,6,28,54,51.9,26,45,17,28,36,85,53,3,Matches
936,Álvaro García,es ESP,"FW,MF",Rayo Vallecano,es La Liga,30,1992,27.5,34,25,15,10,9,7,34,20.6,27,35,0,35,36,70,33,0,Matches
937,Dani García,es ESP,MF,Athletic Club,es La Liga,33,1990,8.3,17,11,4,7,6,12,24,50.0,12,9,3,6,8,25,11,0,Matches
938,David García,es ESP,DF,Osasuna,es La Liga,29,1994,25.9,29,18,19,9,1,16,26,61.5,10,40,19,21,18,47,115,2,Matches
939,Eric García,es ESP,DF,Barcelona,es La Liga,22,2001,0.6,0,0,0,0,0,0,0,,0,1,1,0,0,0,0,0,Matches
940,Eric García,es ESP,DF,Girona,es La Liga,22,2001,29.3,55,37,34,18,3,34,49,69.4,15,36,18,18,30,85,79,2,Matches
941,Fran Garcia,es ESP,DF,Real Madrid,es La Liga,23,1999,15.5,25,17,11,12,2,13,31,41.9,18,16,3,13,19,44,28,1,Matches
942,Gonzalo García,es ESP,"FW,MF",Real Madrid,es La Liga,19,2004,0.2,0,0,0,0,0,0,1,0.0,1,1,1,0,0,0,1,0,Matches
943,Jastin García,es ESP,FW,Girona,es La Liga,19,2004,0.4,1,0,0,0,1,0,0,,0,0,0,0,0,1,1,0,Matches
944,Raúl García,es ESP,"FW,MF",Athletic Club,es La Liga,37,1986,4.7,9,6,2,4,3,4,9,44.4,5,10,1,9,3,12,9,0,Matches
945,Rubén García,es ESP,"FW,MF",Osasuna,es La Liga,30,1993,17.2,32,18,8,17,7,13,33,39.4,20,23,3,20,12,44,23,0,Matches
946,Santiago García,es ESP,FW,Getafe,es La Liga,21,2001,0.3,1,0,0,0,1,1,1,100.0,0,0,0,0,0,1,0,0,Matches
947,Ulisses Garcia,ch SUI,DF,Marseille,fr Ligue 1,27,1996,10.1,21,16,6,13,2,13,20,65.0,7,8,3,5,7,28,13,2,Matches
948,Unai García,es ESP,DF,Osasuna,es La Liga,31,1992,6.2,12,9,9,2,1,5,10,50.0,5,7,1,6,8,20,18,0,Matches
949,Alejandro Garnacho,ar ARG,FW,Manchester Utd,eng Premier League,19,2004,28.5,22,15,7,6,9,12,45,26.7,33,26,2,24,18,40,18,0,Matches
950,James Garner,eng ENG,MF,Everton,eng Premier League,22,2001,33.4,83,44,32,38,13,35,82,42.7,47,45,14,31,45,128,47,1,Matches
951,Luca Garritano,it ITA,"MF,DF",Frosinone,it Serie A,29,1994,5.4,10,5,7,2,1,5,15,33.3,10,13,0,13,4,14,8,1,Matches
952,Yarek Gasiorowski,es ESP,DF,Valencia,es La Liga,18,2005,8.2,22,12,14,5,3,13,19,68.4,6,15,8,7,15,37,50,1,Matches
953,Johan Gastien,fr FRA,MF,Clermont Foot,fr Ligue 1,35,1988,25.1,43,22,18,21,4,23,81,28.4,58,31,9,22,36,79,24,4,Matches
954,Federico Gatti,it ITA,DF,Juventus,it Serie A,25,1998,29.3,33,19,16,16,1,19,24,79.2,5,26,15,11,19,52,90,1,Matches
955,Federico Gattoni,ar ARG,"DF,FW",Sevilla,es La Liga,24,1999,0.1,1,0,1,0,0,1,1,100.0,0,0,0,0,0,1,1,0,Matches
956,Gavi,es ESP,"MF,FW",Barcelona,es La Liga,18,2004,10.5,39,21,20,14,5,18,36,50.0,18,19,3,16,8,47,16,1,Matches
957,Paulo Gazzaniga,ar ARG,GK,Girona,es La Liga,31,1992,38.0,2,2,2,0,0,2,4,50.0,2,0,0,0,0,2,12,1,Matches
958,Yann Gboho,fr FRA,"MF,FW",Toulouse,fr Ligue 1,22,2001,13.3,14,4,6,6,2,8,23,34.8,15,21,1,20,4,18,2,0,Matches
959,Dennis Geiger,de GER,MF,Hoffenheim,de Bundesliga,25,1998,0.7,1,0,1,0,0,0,0,,0,1,1,0,0,1,0,0,Matches
960,Gelabert,es ESP,"MF,FW",Toulouse,fr Ligue 1,22,2000,8.4,14,8,5,6,3,7,20,35.0,13,8,2,6,5,19,8,0,Matches
961,Francesco Gelli,it ITA,"MF,DF",Frosinone,it Serie A,26,1996,17.3,19,13,8,4,7,10,24,41.7,14,19,3,16,11,30,27,1,Matches
962,Luca Gemello,it ITA,GK,Torino,it Serie A,23,2000,2.0,0,0,0,0,0,0,1,0.0,1,0,0,0,0,0,1,1,Matches
963,Valentin Gendrey,fr FRA,DF,Lecce,it Serie A,23,2000,33.8,55,33,35,16,4,30,46,65.2,16,40,11,29,35,90,99,0,Matches
964,Denis Genreau,au AUS,"MF,FW",Toulouse,fr Ligue 1,24,1999,5.2,12,9,6,6,0,8,15,53.3,7,8,1,7,6,18,8,0,Matches
965,Yannick Gerhardt,de GER,"MF,DF",Wolfsburg,de Bundesliga,29,1994,18.1,31,20,16,12,3,9,32,28.1,23,15,2,13,7,38,35,0,Matches
966,Anwar El Ghazi,nl NED,"MF,DF",Mainz 05,de Bundesliga,28,1995,0.6,0,0,0,0,0,0,1,0.0,1,0,0,0,0,0,0,0,Matches
967,Farés Ghedjemis,fr FRA,"FW,MF",Frosinone,it Serie A,20,2002,2.0,2,0,1,0,1,0,2,0.0,2,2,0,2,1,3,2,0,Matches
968,Saman Ghoddos,ir IRN,DF,Brentford,eng Premier League,29,1993,8.2,28,19,19,7,2,17,31,54.8,14,9,2,7,5,33,12,0,Matches
969,Lautaro Gianetti,ar ARG,DF,Udinese,it Serie A,29,1993,7.0,9,4,7,2,0,4,5,80.0,1,10,6,4,19,28,39,0,Matches
970,Morgan Gibbs-White,eng ENG,"MF,FW",Nott'ham Forest,eng Premier League,23,2000,35.1,36,24,6,20,10,14,33,42.4,19,31,8,23,17,53,21,0,Matches
971,Samuel Gigot,fr FRA,DF,Marseille,fr Ligue 1,29,1993,19.2,33,22,16,13,4,13,19,68.4,6,28,18,10,25,58,93,1,Matches
972,Bryan Gil,es ESP,"FW,MF",Tottenham,eng Premier League,22,2001,2.3,1,0,0,0,1,1,4,25.0,3,3,0,3,3,4,4,0,Matches
973,David Gil,es ESP,GK,Cádiz,es La Liga,29,1994,4.1,0,0,0,0,0,0,1,0.0,1,0,0,0,0,0,3,0,Matches
974,Mario Gila,es ESP,DF,Lazio,it Serie A,22,2000,20.1,32,14,23,8,1,19,34,55.9,15,27,14,13,20,52,69,0,Matches
975,Alfie Gilchrist,eng ENG,DF,Chelsea,eng Premier League,19,2003,2.3,4,0,4,0,0,2,5,40.0,3,6,3,3,3,7,11,0,Matches
976,Ryan Giles,eng ENG,"DF,MF",Luton Town,eng Premier League,23,2000,5.6,8,6,4,3,1,2,7,28.6,5,2,0,2,4,12,22,0,Matches
977,Billy Gilmour,sct SCO,MF,Brighton,eng Premier League,22,2001,23.6,26,16,14,10,2,11,35,31.4,24,23,9,14,11,37,14,1,Matches
978,Benedikt Gimber,de GER,DF,Heidenheim,de Bundesliga,26,1997,22.5,40,24,25,14,1,19,35,54.3,16,27,17,10,16,56,101,1,Matches
979,Gvidas Gineitis,lt LTU,MF,Torino,it Serie A,19,2004,6.0,11,7,3,8,0,4,7,57.1,3,10,4,6,4,15,9,1,Matches
980,Matthias Ginter,de GER,DF,Freiburg,de Bundesliga,29,1994,21.3,29,15,19,9,1,16,29,55.2,13,40,26,14,16,45,93,0,Matches
981,Olivier Giroud,fr FRA,FW,Milan,it Serie A,36,1986,26.3,17,11,6,6,5,2,14,14.3,12,14,3,11,6,23,22,0,Matches
982,Jamie Gittens,eng ENG,"FW,MF",Dortmund,de Bundesliga,18,2004,11.8,14,7,6,7,1,2,17,11.8,15,11,2,9,4,18,7,0,Matches
983,Klaus Gjasula,al ALB,"DF,MF",Darmstadt 98,de Bundesliga,33,1989,15.1,44,22,18,25,1,17,30,56.7,13,26,14,12,19,63,42,2,Matches
984,Serge Gnabry,de GER,"FW,MF",Bayern Munich,de Bundesliga,28,1995,4.8,8,5,0,5,3,2,13,15.4,11,5,0,5,3,11,2,0,Matches
985,Ben Godfrey,eng ENG,DF,Everton,eng Premier League,25,1998,12.4,30,20,17,8,5,15,28,53.6,13,14,8,6,16,46,57,0,Matches
986,Edoardo Goldaniga,it ITA,DF,Cagliari,it Serie A,29,1993,11.2,12,7,9,3,0,4,10,40.0,6,11,7,4,15,27,37,1,Matches
987,Pierluigi Gollini,it ITA,GK,Napoli,it Serie A,28,1995,7.0,1,1,1,0,0,1,1,100.0,0,0,0,0,1,2,2,0,Matches
988,Aleksandr Golovin,ru RUS,"MF,FW",Monaco,fr Ligue 1,27,1996,23.9,42,30,14,22,6,15,42,35.7,27,37,3,34,21,63,14,0,Matches
989,André Gomes,pt POR,"MF,FW",Everton,eng Premier League,30,1993,5.6,7,4,2,3,2,3,13,23.1,10,10,1,9,3,10,4,1,Matches
990,Angel Gomes,eng ENG,MF,Lille,fr Ligue 1,22,2000,28.6,26,13,4,15,7,14,32,43.8,18,23,6,17,18,44,28,1,Matches
991,João Gomes,br BRA,MF,Wolves,eng Premier League,22,2001,29.4,128,74,67,49,12,44,99,44.4,55,51,8,43,18,146,29,2,Matches
992,Toti Gomes,pt POR,DF,Wolves,eng Premier League,24,1999,30.8,44,25,32,8,4,24,37,64.9,13,40,19,21,26,70,93,2,Matches
993,Joe Gomez,eng ENG,DF,Liverpool,eng Premier League,26,1997,19.8,47,31,24,16,7,30,63,47.6,33,26,4,22,19,66,50,2,Matches
994,Maxi Gómez,uy URU,FW,Cádiz,es La Liga,26,1996,12.9,6,4,2,3,1,3,5,60.0,2,8,3,5,3,9,3,0,Matches
995,Moi Gómez,es ESP,"MF,FW",Osasuna,es La Liga,29,1994,22.3,30,19,7,19,4,9,24,37.5,15,15,1,14,11,41,22,0,Matches
996,Papu Gómez,ar ARG,"MF,FW",Monza,it Serie A,35,1988,0.5,0,0,0,0,0,0,2,0.0,2,0,0,0,1,1,0,0,Matches
997,Sergio Gómez,es ESP,"FW,MF",Manchester City,eng Premier League,22,2000,0.6,1,0,0,1,0,1,2,50.0,1,0,0,0,1,2,0,0,Matches
998,Unai Gómez,es ESP,MF,Athletic Club,es La Liga,20,2003,9.7,12,10,2,6,4,5,10,50.0,5,13,2,11,2,14,9,0,Matches
999,Iron Gomis,fr FRA,MF,Salernitana,it Serie A,23,1999,1.5,4,1,2,2,0,0,1,0.0,1,2,0,2,2,6,2,0,Matches
1000,Maxime Gonalons,fr FRA,MF,Clermont Foot,fr Ligue 1,34,1989,14.4,47,33,14,27,6,25,57,43.9,32,18,3,15,20,67,11,0,Matches
1001,Édgar González,es ESP,"DF,MF",Almería,es La Liga,26,1997,28.0,45,21,22,20,3,25,49,51.0,24,48,28,20,38,83,130,3,Matches
1002,Enso Gonzalez,py PAR,"MF,DF",Wolves,eng Premier League,18,2005,0.0,0,0,0,0,0,0,1,0.0,1,0,0,0,0,0,0,0,Matches
1003,Fabio González,es ESP,MF,Las Palmas,es La Liga,26,1997,1.4,2,2,2,0,0,1,2,50.0,1,2,0,2,0,2,0,0,Matches
1004,Giovanni González,uy URU,DF,Mallorca,es La Liga,28,1994,27.4,73,45,37,32,4,40,81,49.4,41,24,3,21,31,104,60,2,Matches
1005,Hugo González,es ESP,"MF,FW",Valencia,es La Liga,20,2003,1.0,2,1,0,2,0,0,0,,0,0,0,0,0,2,0,0,Matches
1006,Iñaki González,es ESP,MF,Las Palmas,es La Liga,19,2004,0.1,1,0,1,0,0,0,0,,0,0,0,0,0,1,1,0,Matches
1007,Joan Gonzàlez,es ESP,MF,Lecce,it Serie A,21,2002,14.3,31,18,16,12,3,17,28,60.7,11,20,3,17,5,36,9,0,Matches
1008,Nicolás González,ar ARG,FW,Fiorentina,it Serie A,25,1998,21.3,28,18,15,8,5,8,28,28.6,20,26,1,25,12,40,9,0,Matches
1009,Peter González,do DOM,"MF,FW",Valencia,es La Liga,21,2002,7.2,5,3,3,1,1,1,10,10.0,9,11,0,11,7,12,10,0,Matches
1010,Urko González,es ESP,MF,Real Sociedad,es La Liga,22,2001,1.7,4,1,0,3,1,2,2,100.0,0,1,0,1,1,5,6,0,Matches
1011,Anthony Gordon,eng ENG,FW,Newcastle Utd,eng Premier League,22,2001,32.1,55,34,16,28,11,22,64,34.4,42,27,0,27,7,62,7,0,Matches
1012,Kaide Gordon,eng ENG,FW,Liverpool,eng Premier League,18,2004,0.0,0,0,0,0,0,0,0,,0,0,0,0,0,0,0,0,Matches
1013,Daniel Gore,eng ENG,MF,Manchester Utd,eng Premier League,18,2004,0.0,1,1,0,1,0,1,1,100.0,0,0,0,0,1,2,0,0,Matches
1014,Leon Goretzka,de GER,MF,Bayern Munich,de Bundesliga,28,1995,24.9,41,23,18,14,9,24,54,44.4,30,44,8,36,31,72,42,1,Matches
1015,Mathieu Gorgelin,fr FRA,GK,Le Havre,fr Ligue 1,32,1990,1.0,0,0,0,0,0,0,0,,0,0,0,0,0,0,0,0,Matches
1016,Andoni Gorosabel,es ESP,DF,Alavés,es La Liga,26,1996,31.7,62,42,40,17,5,38,75,50.7,37,24,8,16,28,90,69,0,Matches
1017,Robin Gosens,de GER,"DF,MF",Union Berlin,de Bundesliga,29,1994,25.4,63,44,25,31,7,30,44,68.2,14,52,9,43,36,99,75,0,Matches
1018,Mario Götze,de GER,MF,Eint Frankfurt,de Bundesliga,31,1992,23.0,51,34,18,25,8,28,62,45.2,34,19,3,16,14,65,10,0,Matches
1019,Amine Gouiri,dz ALG,"FW,MF",Rennes,fr Ligue 1,23,2000,23.0,20,10,4,11,5,8,19,42.1,11,18,1,17,14,34,12,0,Matches
1020,Jeffrey Gouweleeuw,nl NED,DF,Augsburg,de Bundesliga,32,1991,28.8,35,23,13,17,5,16,25,64.0,9,44,24,20,35,70,108,0,Matches
1021,Pablo Gozalbez,es ESP,"MF,FW",Valencia,es La Liga,22,2001,1.1,1,0,0,0,1,1,6,16.7,5,0,0,0,1,2,2,0,Matches
1022,Jonathan Gradit,fr FRA,DF,Lens,fr Ligue 1,30,1992,23.5,32,20,15,14,3,19,35,54.3,16,30,17,13,37,69,61,0,Matches
1023,Jens Grahl,de GER,GK,Eint Frankfurt,de Bundesliga,34,1988,2.0,0,0,0,0,0,0,0,,0,0,0,0,0,0,3,0,Matches
1024,Samuel Grandsir,fr FRA,"MF,FW",Le Havre,fr Ligue 1,26,1996,6.7,16,12,5,9,2,8,18,44.4,10,4,0,4,3,19,3,1,Matches
1025,Alberto Grassi,it ITA,MF,Empoli,it Serie A,28,1995,20.1,30,18,13,13,4,10,26,38.5,16,26,11,15,41,71,37,0,Matches
1026,Ryan Gravenberch,nl NED,MF,Liverpool,eng Premier League,21,2002,12.5,26,12,5,13,8,12,29,41.4,17,20,2,18,14,40,11,0,Matches
1027,Ryan Gravenberch,nl NED,FW,Bayern Munich,de Bundesliga,21,2002,0.1,0,0,0,0,0,0,0,,0,0,0,0,0,0,0,0,Matches
1028,Adrian Grbić,at AUT,FW,Lorient,fr Ligue 1,26,1996,0.3,0,0,0,0,0,0,0,,0,0,0,0,0,0,0,0,Matches
1029,Ivo Grbić,hr CRO,GK,Sheffield Utd,eng Premier League,27,1996,8.6,0,0,0,0,0,0,1,0.0,1,1,0,1,0,0,9,1,Matches
1030,Jack Grealish,eng ENG,"FW,MF",Manchester City,eng Premier League,27,1995,11.2,13,8,6,7,0,6,12,50.0,6,13,2,11,6,19,5,0,Matches
1031,Mason Greenwood,eng ENG,"MF,FW",Getafe,es La Liga,21,2001,29.6,11,6,3,5,3,4,21,19.0,17,9,0,9,4,15,4,0,Matches
1032,Michael Gregoritsch,at AUT,FW,Freiburg,de Bundesliga,29,1994,18.7,16,12,8,5,3,2,14,14.3,12,17,4,13,9,25,27,0,Matches
1033,Dominik Greif,sk SVK,GK,Mallorca,es La Liga,26,1997,1.0,0,0,0,0,0,0,0,,0,0,0,0,0,0,0,0,Matches
1034,Antoine Griezmann,fr FRA,"FW,MF",Atlético Madrid,es La Liga,32,1991,29.4,33,19,14,14,5,15,41,36.6,26,34,3,31,10,43,23,1,Matches
1035,Vincenzo Grifo,it ITA,"MF,FW",Freiburg,de Bundesliga,30,1993,25.8,31,20,14,11,6,14,31,45.2,17,22,1,21,15,46,20,0,Matches
1036,Florian Grillitsch,at AUT,"DF,MF",Hoffenheim,de Bundesliga,27,1995,25.5,54,28,31,19,4,22,54,40.7,32,41,20,21,52,106,90,2,Matches
1037,Álex Grimaldo,es ESP,DF,Leverkusen,de Bundesliga,27,1995,30.9,45,24,26,10,9,30,55,54.5,25,32,7,25,22,67,41,0,Matches
1038,Christian Groß,de GER,"DF,MF",Werder Bremen,de Bundesliga,34,1989,8.9,21,16,11,9,1,11,25,44.0,14,17,6,11,13,34,28,1,Matches
1039,Pascal Groß,de GER,"MF,DF",Brighton,eng Premier League,32,1991,34.6,70,46,33,21,16,31,72,43.1,41,41,8,33,22,92,32,3,Matches
1040,Brajan Gruda,de GER,"MF,FW",Mainz 05,de Bundesliga,19,2004,18.2,22,14,5,11,6,14,24,58.3,10,15,0,15,5,27,4,0,Matches
1041,Ilia Gruev,bg BUL,MF,Werder Bremen,de Bundesliga,23,2000,0.0,0,0,0,0,0,0,0,,0,0,0,0,0,0,0,0,Matches
1042,Vicente Guaita,es ESP,GK,Celta Vigo,es La Liga,36,1987,26.7,1,1,1,0,0,1,2,50.0,1,0,0,0,0,1,9,1,Matches
1043,Andrés Guardado,mx MEX,MF,Betis,es La Liga,36,1986,5.0,17,12,5,9,3,7,14,50.0,7,4,2,2,6,23,5,0,Matches
1044,Sergi Guardiola,es ESP,"FW,MF",Cádiz,es La Liga,32,1991,5.5,10,7,2,6,2,4,9,44.4,5,10,0,10,0,10,4,0,Matches
1045,Nemanja Gudelj,rs SRB,"DF,MF",Sevilla,es La Liga,31,1991,19.4,31,24,18,10,3,17,31,54.8,14,17,9,8,27,58,56,0,Matches
1046,Gabriel Gudmundsson,se SWE,"DF,FW",Lille,fr Ligue 1,24,1999,14.1,22,16,7,13,2,12,20,60.0,8,14,3,11,15,37,25,0,Matches
1047,Gonçalo Guedes,pt POR,"FW,MF",Villarreal,es La Liga,26,1996,10.6,6,4,1,2,3,2,7,28.6,5,8,0,8,2,8,3,0,Matches
1048,Axel Gueguin,fr FRA,"DF,FW",Montpellier,fr Ligue 1,18,2005,1.5,9,5,6,2,1,2,6,33.3,4,2,0,2,2,11,6,0,Matches
1049,Marc Guéhi,eng ENG,DF,Crystal Palace,eng Premier League,23,2000,22.5,28,19,21,7,0,14,24,58.3,10,22,17,5,18,46,89,1,Matches
1050,Mattéo Guendouzi,fr FRA,MF,Lazio,it Serie A,24,1999,26.3,34,15,11,18,5,21,49,42.9,28,24,6,18,21,55,24,1,Matches
1051,Mattéo Guendouzi,fr FRA,MF,Marseille,fr Ligue 1,24,1999,0.2,0,0,0,0,0,0,0,,0,1,1,0,0,0,0,0,Matches
1052,Javier Guerra,es ESP,MF,Valencia,es La Liga,20,2003,27.8,54,24,25,22,7,22,58,37.9,36,27,7,20,18,72,44,0,Matches
1053,Raphaël Guerreiro,pt POR,"DF,MF",Bayern Munich,de Bundesliga,29,1993,13.2,19,16,6,9,4,9,15,60.0,6,7,1,6,15,34,5,1,Matches
1054,Axel Guessand,fr FRA,DF,Udinese,it Serie A,18,2004,0.5,1,1,0,1,0,1,1,100.0,0,1,0,1,0,1,0,0,Matches
1055,Evann Guessand,ci CIV,FW,Nice,fr Ligue 1,22,2001,17.3,16,7,2,7,7,6,7,85.7,1,12,1,11,12,28,7,0,Matches
1056,Ander Guevara,es ESP,MF,Alavés,es La Liga,26,1997,32.6,59,32,28,25,6,31,64,48.4,33,34,12,22,13,72,46,1,Matches
1057,Pape Gueye,sn SEN,"MF,DF",Marseille,fr Ligue 1,24,1999,8.5,33,21,11,19,3,13,19,68.4,6,17,3,14,13,46,12,0,Matches
1058,Josuha Guilavogui,fr FRA,DF,Mainz 05,de Bundesliga,32,1990,4.5,15,10,10,5,0,6,7,85.7,1,13,7,6,13,28,21,0,Matches
1059,Morgan Guilavogui,gn GUI,"FW,MF",Lens,fr Ligue 1,25,1998,6.3,21,10,4,12,5,5,11,45.5,6,11,2,9,4,25,7,0,Matches
1060,Frederic Guilbert,fr FRA,"DF,MF",Strasbourg,fr Ligue 1,28,1994,27.7,87,50,49,30,8,47,72,65.3,25,39,10,29,71,158,99,1,Matches
1061,Hugo Guillamón,es ESP,MF,Valencia,es La Liga,23,2000,14.6,24,15,7,14,3,11,17,64.7,6,8,3,5,12,36,25,2,Matches
1062,Bruno Guimarães,br BRA,MF,Newcastle Utd,eng Premier League,25,1997,36.3,88,53,45,32,11,40,77,51.9,37,52,14,38,35,123,20,0,Matches
1063,Serhou Guirassy,gn GUI,FW,Stuttgart,de Bundesliga,27,1996,24.5,6,3,1,4,1,2,5,40.0,3,8,1,7,6,12,29,0,Matches
1064,Marc Guiu,es ESP,"FW,MF",Barcelona,es La Liga,17,2006,0.8,1,0,0,1,0,0,0,,0,0,0,0,0,1,0,0,Matches
1065,Péter Gulácsi,hu HUN,GK,RB Leipzig,de Bundesliga,33,1990,13.0,0,0,0,0,0,0,0,,0,0,0,0,0,0,8,1,Matches
1066,Manuel Gulde,de GER,DF,Freiburg,de Bundesliga,32,1991,22.7,37,23,23,13,1,17,23,73.9,6,24,14,10,25,62,82,0,Matches
1067,Arda Güler,tr TUR,"FW,MF",Real Madrid,es La Liga,18,2005,4.2,6,4,1,3,2,5,8,62.5,3,0,0,0,2,8,5,0,Matches
1068,Gerard Gumbau,es ESP,MF,Granada,es La Liga,28,1994,29.7,55,34,21,30,4,23,62,37.1,39,24,5,19,25,80,30,2,Matches
1069,Robert Gumny,pl POL,DF,Augsburg,de Bundesliga,25,1998,5.3,6,5,1,3,2,1,5,20.0,4,13,5,8,7,13,15,0,Matches
1070,İlkay Gündoğan,de GER,MF,Barcelona,es La Liga,32,1990,33.3,32,22,14,16,2,12,39,30.8,27,19,4,15,21,53,18,1,Matches
1071,Christian Günter,de GER,DF,Freiburg,de Bundesliga,30,1993,11.8,20,12,9,11,0,7,18,38.9,11,9,3,6,2,22,16,0,Matches
1072,Jon Guridi,es ESP,MF,Alavés,es La Liga,28,1995,29.8,42,24,10,27,5,12,45,26.7,33,23,3,20,22,64,22,0,Matches
1073,Gorka Guruzeta,es ESP,FW,Athletic Club,es La Liga,26,1996,24.6,34,23,6,25,3,9,30,30.0,21,36,2,34,17,51,23,0,Matches
1074,Malo Gusto,fr FRA,DF,Chelsea,eng Premier League,20,2003,19.5,55,27,34,15,6,35,52,67.3,17,28,4,24,17,72,43,1,Matches
1075,Miguel Gutiérrez,es ESP,DF,Girona,es La Liga,22,2001,33.7,29,18,11,14,4,13,35,37.1,22,27,11,16,22,51,66,2,Matches
1076,Albert Guðmundsson,is ISL,"FW,MF",Genoa,it Serie A,26,1997,33.5,23,10,8,10,5,12,44,27.3,32,15,2,13,11,34,13,0,Matches
1077,Joško Gvardiol,hr CRO,DF,Manchester City,eng Premier League,21,2002,25.9,55,33,21,24,10,21,38,55.3,17,36,12,24,27,82,37,3,Matches
1078,Emmanuel Gyasi,gh GHA,"DF,FW",Empoli,it Serie A,29,1994,20.9,34,17,18,13,3,15,32,46.9,17,30,12,18,5,39,27,1,Matches
1079,Norbert Gyömbér,sk SVK,DF,Salernitana,it Serie A,31,1992,19.6,36,18,30,6,0,20,26,76.9,6,33,23,10,23,59,77,2,Matches
1080,Erling Haaland,no NOR,FW,Manchester City,eng Premier League,23,2000,28.4,6,3,0,3,3,2,3,66.7,1,11,1,10,2,8,16,0,Matches
1081,Nicolas Haas,ch SUI,MF,Empoli,it Serie A,27,1996,1.0,5,3,1,2,2,3,3,100.0,0,1,0,1,1,6,1,0,Matches
1082,Janik Haberer,de GER,"MF,DF",Union Berlin,de Bundesliga,29,1994,13.6,36,24,16,13,7,22,45,48.9,23,21,4,17,12,48,18,0,Matches
1083,Robin Hack,de GER,"FW,MF",Gladbach,de Bundesliga,24,1998,15.0,15,8,6,7,2,4,17,23.5,13,16,0,16,14,29,21,0,Matches
1084,Antwoine Hackford,eng ENG,FW,Sheffield Utd,eng Premier League,19,2004,0.1,0,0,0,0,0,0,0,,0,0,0,0,0,0,0,0,Matches
1085,Munir El Haddadi,ma MAR,FW,Las Palmas,es La Liga,27,1995,27.2,40,27,18,17,5,17,38,44.7,21,27,1,26,11,51,16,0,Matches
1086,Jaouen Hadjam,dz ALG,DF,Nantes,fr Ligue 1,20,2003,1.2,6,4,5,1,0,1,2,50.0,1,0,0,0,3,9,2,0,Matches
1087,Ianis Hagi,ro ROU,"MF,FW",Alavés,es La Liga,24,1998,8.9,17,12,2,14,1,5,12,41.7,7,8,0,8,5,22,4,0,Matches
1088,Amadou Haidara,ml MLI,MF,RB Leipzig,de Bundesliga,25,1998,17.0,42,27,24,16,2,23,41,56.1,18,28,6,22,21,63,37,0,Matches
1089,Massadio Haïdara,ml MLI,DF,Lens,fr Ligue 1,30,1992,8.2,9,8,5,3,1,4,6,66.7,2,7,2,5,11,20,32,3,Matches
1090,Oualid El Hajjam,ma MAR,"DF,MF",Le Havre,fr Ligue 1,32,1991,4.4,8,7,5,2,1,2,9,22.2,7,5,1,4,6,14,10,0,Matches
1091,Achraf Hakimi,ma MAR,DF,Paris S-G,fr Ligue 1,24,1998,21.5,29,19,14,9,6,17,34,50.0,17,28,4,24,12,41,28,2,Matches
1092,Lewis Hall,eng ENG,DF,Newcastle Utd,eng Premier League,18,2004,8.7,28,18,17,10,1,17,28,60.7,11,17,2,15,12,40,22,1,Matches
1093,Sébastien Haller,ci CIV,FW,Dortmund,de Bundesliga,29,1994,4.4,1,0,0,1,0,1,1,100.0,0,4,1,3,0,1,7,0,Matches
1094,Gustavo Hamer,nl NED,MF,Sheffield Utd,eng Premier League,26,1997,32.3,39,21,17,15,7,16,59,27.1,43,33,9,24,29,68,35,0,Matches
1095,Andreas Hanche-Olsen,no NOR,DF,Mainz 05,de Bundesliga,26,1997,11.0,20,12,10,8,2,10,16,62.5,6,10,4,6,11,31,41,0,Matches
1096,Isak Hansen-Aarøen,no NOR,MF,Werder Bremen,de Bundesliga,18,2004,0.3,0,0,0,0,0,0,1,0.0,1,1,0,1,1,1,0,0,Matches
1097,Ridgeciano Haps,sr SUR,DF,Genoa,it Serie A,30,1993,8.6,7,6,3,2,2,5,8,62.5,3,3,0,3,6,13,11,1,Matches
1098,Genki Haraguchi,jp JPN,MF,Stuttgart,de Bundesliga,32,1991,0.3,1,1,1,0,0,0,0,,0,0,0,0,0,1,1,0,Matches
1099,Amine Harit,ma MAR,"MF,FW",Marseille,fr Ligue 1,26,1997,20.2,28,16,8,17,3,13,37,35.1,24,31,4,27,12,40,4,0,Matches
1100,Luke Harris,wls WAL,MF,Fulham,eng Premier League,18,2005,0.8,1,1,1,0,0,0,1,0.0,1,0,0,0,0,1,0,0,Matches
1101,Jack Harrison,eng ENG,"MF,FW",Everton,eng Premier League,26,1996,24.6,37,22,12,12,13,17,49,34.7,32,25,5,20,12,49,24,0,Matches
1102,Abdou Harroui,nl NED,"MF,FW",Frosinone,it Serie A,25,1998,11.3,23,11,11,11,1,8,16,50.0,8,19,3,16,5,28,8,0,Matches
1103,Makoto Hasebe,jp JPN,"DF,MF",Eint Frankfurt,de Bundesliga,39,1984,2.4,4,2,2,2,0,3,6,50.0,3,2,1,1,2,6,5,0,Matches
1104,Daiki Hashioka,jp JPN,DF,Luton Town,eng Premier League,24,1999,6.6,11,5,6,4,1,5,11,45.5,6,12,7,5,8,19,20,0,Matches
1105,Hans Hateboer,nl NED,DF,Atalanta,it Serie A,29,1994,12.4,12,5,8,2,2,5,15,33.3,10,21,7,14,4,16,21,0,Matches
1106,Pantelis Hatzidiakos,gr GRE,DF,Cagliari,it Serie A,26,1997,9.5,22,10,12,10,0,10,17,58.8,7,14,5,9,13,35,30,1,Matches
1107,Kai Havertz,de GER,"MF,FW",Arsenal,eng Premier League,24,1999,29.3,35,15,7,21,7,14,39,35.9,25,26,1,25,20,55,22,0,Matches
1108,Thorgan Hazard,be BEL,DF,Dortmund,de Bundesliga,30,1993,0.1,0,0,0,0,0,0,0,,0,0,0,0,0,0,0,0,Matches
1109,Jan Paul van Hecke,nl NED,DF,Brighton,eng Premier League,23,2000,26.3,47,26,25,19,3,27,45,60.0,18,49,27,22,30,77,76,4,Matches
1110,Hwang Hee-chan,kr KOR,"FW,MF",Wolves,eng Premier League,27,1996,23.5,20,10,11,8,1,9,24,37.5,15,19,1,18,10,30,9,0,Matches
1111,Silvan Hefti,ch SUI,"MF,DF",Genoa,it Serie A,25,1997,1.3,6,1,2,3,1,4,7,57.1,3,2,0,2,0,6,1,0,Matches
1112,Silvan Hefti,ch SUI,"DF,FW",Montpellier,fr Ligue 1,25,1997,7.9,21,15,10,7,4,15,29,51.7,14,7,2,5,8,29,11,0,Matches
1113,Dominique Heintz,de GER,DF,Köln,de Bundesliga,29,1993,6.3,12,5,6,6,0,8,12,66.7,4,6,1,5,3,15,28,0,Matches
1114,Dean Henderson,eng ENG,GK,Crystal Palace,eng Premier League,26,1997,18.0,1,1,1,0,0,1,2,50.0,1,0,0,0,0,1,8,2,Matches
1115,Liam Henderson,sct SCO,MF,Empoli,it Serie A,27,1996,0.1,0,0,0,0,0,0,0,,0,0,0,0,0,0,0,0,Matches
1116,Benjamin Henrichs,de GER,DF,RB Leipzig,de Bundesliga,26,1997,28.1,68,39,32,26,10,27,58,46.6,31,49,4,45,33,101,37,0,Matches
1117,Henrique,br BRA,DF,Lyon,fr Ligue 1,29,1994,6.7,10,6,6,4,0,6,11,54.5,5,8,2,6,10,20,3,0,Matches
1118,Luis Henrique,br BRA,"FW,DF",Marseille,fr Ligue 1,21,2001,8.7,8,7,4,1,3,4,7,57.1,3,9,0,9,8,16,3,0,Matches
1119,Luiz Henrique,br BRA,FW,Betis,es La Liga,22,2001,6.8,15,11,4,10,1,9,14,64.3,5,11,0,11,5,20,8,0,Matches
1120,Matheus Henrique,br BRA,MF,Sassuolo,it Serie A,25,1997,27.8,43,29,21,18,4,18,43,41.9,25,18,8,10,25,68,31,6,Matches
1121,Rico Henry,eng ENG,DF,Brentford,eng Premier League,26,1997,4.5,7,5,3,3,1,6,7,85.7,1,8,3,5,5,12,5,1,Matches
1122,Thomas Henry,fr FRA,FW,Hellas Verona,it Serie A,28,1994,3.7,0,0,0,0,0,0,0,,0,0,0,0,0,0,5,0,Matches
1123,Christophe Hérelle,mq MTQ,DF,Metz,fr Ligue 1,30,1992,18.0,32,15,24,7,1,13,23,56.5,10,16,9,7,18,50,68,2,Matches
1124,Mario Hermoso,es ESP,DF,Atlético Madrid,es La Liga,28,1995,28.4,46,25,29,13,4,28,51,54.9,23,27,9,18,30,76,93,0,Matches
1125,Javi Hernández,es ESP,DF,Cádiz,es La Liga,25,1998,27.9,43,24,26,12,5,25,46,54.3,21,34,9,25,19,62,72,1,Matches
1126,Aridane Hernández,es ESP,DF,Rayo Vallecano,es La Liga,34,1989,18.8,10,8,5,4,1,4,11,36.4,7,19,14,5,14,24,98,1,Matches
1127,Lucas Hernández,fr FRA,DF,Paris S-G,fr Ligue 1,27,1996,21.2,52,36,28,15,9,29,50,58.0,21,21,5,16,27,79,38,0,Matches
1128,Luis Hernández,es ESP,DF,Cádiz,es La Liga,34,1989,8.0,7,3,4,3,0,4,8,50.0,4,3,2,1,8,15,25,0,Matches
1129,Theo Hernández,fr FRA,DF,Milan,it Serie A,25,1997,31.0,30,17,19,11,0,11,22,50.0,11,33,13,20,23,53,42,1,Matches
1130,Jorge Herrando,es ESP,DF,Osasuna,es La Liga,22,2001,18.3,29,19,23,6,0,12,19,63.2,7,20,11,9,15,44,69,1,Matches
1131,Ander Herrera,es ESP,MF,Athletic Club,es La Liga,33,1989,11.4,44,32,11,26,7,20,36,55.6,16,16,6,10,15,59,18,1,Matches
1132,Cristian Herrera,es ESP,"FW,MF",Las Palmas,es La Liga,32,1991,1.8,1,1,0,1,0,1,2,50.0,1,1,0,1,0,1,2,0,Matches
1133,Sergio Herrera,es ESP,GK,Osasuna,es La Liga,30,1993,31.9,2,2,2,0,0,2,3,66.7,1,0,0,0,0,2,22,3,Matches
1134,Yangel Herrera,ve VEN,MF,Girona,es La Liga,25,1998,23.4,64,37,28,30,6,30,56,53.6,26,30,8,22,24,88,45,1,Matches
1135,Patrick Herrmann,de GER,"FW,DF",Gladbach,de Bundesliga,32,1991,1.0,4,4,2,1,1,2,2,100.0,0,1,0,1,1,5,2,0,Matches
1136,Juan Herzog,es ESP,DF,Las Palmas,es La Liga,20,2003,3.2,6,5,5,1,0,3,6,50.0,3,4,1,3,2,8,17,0,Matches
1137,Son Heung-min,kr KOR,FW,Tottenham,eng Premier League,31,1992,32.6,21,13,6,7,8,10,21,47.6,11,4,1,3,8,29,4,0,Matches
1138,Aaron Hickey,sct SCO,DF,Brentford,eng Premier League,21,2002,7.9,16,9,9,3,4,7,7,100.0,0,7,3,4,3,19,10,0,Matches
1139,Isak Hien,se SWE,DF,Hellas Verona,it Serie A,24,1999,9.6,17,10,10,7,0,10,19,52.6,9,12,5,7,7,24,33,1,Matches
1140,Isak Hien,se SWE,DF,Atalanta,it Serie A,24,1999,10.4,18,12,8,10,0,7,15,46.7,8,12,5,7,14,32,33,0,Matches
1141,James Hill,eng ENG,DF,Bournemouth,eng Premier League,21,2002,0.8,3,2,1,2,0,1,1,100.0,0,3,2,1,3,6,8,0,Matches
1142,Piero Hincapié,ec ECU,DF,Leverkusen,de Bundesliga,21,2002,16.5,35,22,14,17,4,13,17,76.5,4,18,7,11,13,48,43,0,Matches
1143,Jack Hinshelwood,eng ENG,DF,Brighton,eng Premier League,18,2005,9.7,14,5,7,4,3,5,13,38.5,8,6,2,4,14,28,18,0,Matches
1144,Adam Hložek,cz CZE,"MF,FW",Leverkusen,de Bundesliga,21,2002,5.1,10,4,2,4,4,3,7,42.9,4,4,1,3,2,12,1,0,Matches
1145,Nicolas Höfler,de GER,MF,Freiburg,de Bundesliga,33,1990,25.9,63,40,36,20,7,22,49,44.9,27,30,16,14,31,94,45,0,Matches
1146,Jonas Hofmann,de GER,MF,Leverkusen,de Bundesliga,31,1992,24.5,20,14,6,9,5,10,24,41.7,14,18,0,18,8,28,6,0,Matches
1147,Philipp Hofmann,de GER,FW,Bochum,de Bundesliga,30,1993,17.5,10,5,4,5,1,4,7,57.1,3,11,2,9,4,14,17,0,Matches
1148,Lucas Höler,de GER,"FW,MF",Freiburg,de Bundesliga,29,1994,25.6,32,24,14,10,8,4,23,17.4,19,19,4,15,15,47,35,0,Matches
1149,Mason Holgate,jm JAM,DF,Sheffield Utd,eng Premier League,26,1996,7.9,12,7,5,6,1,5,12,41.7,7,12,5,7,11,23,40,0,Matches
1150,Fabian Holland,de GER,"MF,DF",Darmstadt 98,de Bundesliga,33,1990,20.4,47,26,18,21,8,20,37,54.1,17,22,12,10,24,71,29,0,Matches
1151,Benedict Hollerbach,de GER,"FW,MF",Union Berlin,de Bundesliga,22,2001,14.2,17,11,5,7,5,7,22,31.8,15,28,0,28,4,21,3,0,Matches
1152,Emil Holm,se SWE,DF,Atalanta,it Serie A,23,2000,10.5,28,19,17,9,2,16,36,44.4,20,25,3,22,7,35,25,0,Matches
1153,Gerrit Holtmann,ph PHI,"MF,FW",Darmstadt 98,de Bundesliga,28,1995,4.4,8,5,3,4,1,7,10,70.0,3,7,0,7,2,10,4,1,Matches
1154,Martin Hongla,cm CMR,MF,Hellas Verona,it Serie A,25,1998,12.0,24,13,9,13,2,8,11,72.7,3,8,3,5,7,31,24,0,Matches
1155,Martin Hongla,cm CMR,"MF,DF",Granada,es La Liga,25,1998,6.2,7,3,2,5,0,3,9,33.3,6,6,3,3,6,13,13,1,Matches
1156,Franck Honorat,fr FRA,"DF,FW",Gladbach,de Bundesliga,26,1996,26.1,25,13,13,10,2,11,20,55.0,9,22,3,19,9,34,35,1,Matches
1157,Mathias Honsak,at AUT,"FW,MF",Darmstadt 98,de Bundesliga,26,1996,11.3,14,7,7,6,1,6,20,30.0,14,14,2,12,8,22,25,0,Matches
1158,Sydney van Hooijdonk,nl NED,FW,Bologna,it Serie A,23,2000,2.4,3,0,0,2,1,1,2,50.0,1,1,1,0,1,4,4,0,Matches
1159,Fraser Hornby,sct SCO,"FW,MF",Darmstadt 98,de Bundesliga,23,1999,2.4,0,0,0,0,0,0,1,0.0,1,2,1,1,0,0,4,0,Matches
1160,Lukáš Hrádecký,fi FIN,GK,Leverkusen,de Bundesliga,33,1989,33.0,0,0,0,0,0,0,1,0.0,1,1,0,1,0,0,10,2,Matches
1161,Xabier Huarte Armendáriz,es ESP,MF,Osasuna,es La Liga,22,2001,0.1,0,0,0,0,0,0,0,,0,0,0,0,0,0,0,0,Matches
1162,Timo Hübers,de GER,DF,Köln,de Bundesliga,27,1996,30.9,68,47,51,14,3,49,80,61.3,31,54,28,26,63,131,168,1,Matches
1163,Callum Hudson-Odoi,eng ENG,"FW,MF",Nott'ham Forest,eng Premier League,22,2000,20.6,18,8,4,5,9,7,28,25.0,21,16,1,15,7,25,12,1,Matches
1164,Will Hughes,eng ENG,MF,Crystal Palace,eng Premier League,28,1995,21.0,61,33,30,20,11,24,48,50.0,24,36,14,22,21,82,25,0,Matches
1165,Dean Huijsen,es ESP,DF,Roma,it Serie A,18,2005,5.7,10,5,5,5,0,1,4,25.0,3,7,4,3,4,14,26,2,Matches
1166,Dean Huijsen,es ESP,DF,Juventus,it Serie A,18,2005,0.1,0,0,0,0,0,0,0,,0,0,0,0,0,0,1,0,Matches
1167,Mats Hummels,de GER,DF,Dortmund,de Bundesliga,34,1988,17.6,52,34,34,12,6,30,53,56.6,23,33,11,22,33,85,82,0,Matches
1168,Denis Huseinbasic,ba BIH,MF,Köln,de Bundesliga,22,2001,18.1,38,18,17,15,6,20,31,64.5,11,26,1,25,13,51,14,0,Matches
1169,Elseid Hysaj,al ALB,DF,Lazio,it Serie A,29,1994,13.3,24,14,8,13,3,15,24,62.5,9,16,6,10,17,41,31,0,Matches
1170,Pierre Højbjerg,dk DEN,MF,Tottenham,eng Premier League,27,1995,14.6,32,18,13,17,2,13,34,38.2,21,21,7,14,19,51,30,3,Matches
1171,Rasmus Højlund,dk DEN,FW,Manchester Utd,eng Premier League,20,2003,24.0,11,7,2,3,6,5,13,38.5,8,9,1,8,1,12,19,0,Matches
1172,Iago,br BRA,DF,Augsburg,de Bundesliga,26,1997,18.0,36,17,22,10,4,17,33,51.5,16,39,8,31,18,54,43,0,Matches
1173,Pablo Ibáñez,es ESP,MF,Osasuna,es La Liga,24,1998,12.8,18,9,5,7,6,5,21,23.8,16,26,3,23,9,27,17,0,Matches
1174,Arijon Ibrahimović,de GER,"FW,DF",Frosinone,it Serie A,17,2005,5.3,7,6,4,2,1,1,9,11.1,8,4,0,4,1,8,3,0,Matches
1175,Iglesias,es ESP,"DF,FW",Getafe,es La Liga,25,1998,15.7,41,22,25,11,5,21,33,63.6,12,18,7,11,16,57,53,0,Matches
1176,Borja Iglesias,es ESP,FW,Betis,es La Liga,30,1993,4.5,0,0,0,0,0,0,3,0.0,3,0,0,0,2,2,2,0,Matches
1177,Borja Iglesias,es ESP,FW,Leverkusen,de Bundesliga,30,1993,2.8,1,0,0,1,0,0,1,0.0,1,2,0,2,1,2,1,0,Matches
1178,Igor,br BRA,DF,Brighton,eng Premier League,25,1998,18.2,25,18,7,16,2,17,29,58.6,12,22,9,13,14,39,52,1,Matches
1179,Jonathan Ikone,fr FRA,FW,Fiorentina,it Serie A,25,1998,18.7,22,11,7,9,6,10,17,58.8,7,12,0,12,3,25,8,0,Matches
1180,Chukwubuikem Ikwuemesi,ng NGA,FW,Salernitana,it Serie A,21,2001,11.8,3,1,0,2,1,2,6,33.3,4,1,1,0,1,4,8,0,Matches
1181,Andrej Ilic,rs SRB,FW,Lille,fr Ligue 1,23,2000,0.1,0,0,0,0,0,0,0,,0,0,0,0,0,0,0,0,Matches
1182,Ivan Ilić,rs SRB,MF,Torino,it Serie A,22,2001,23.3,22,8,9,10,3,13,27,48.1,14,20,7,13,20,42,31,0,Matches
1183,Samuel Iling-Junior,eng ENG,"DF,MF",Juventus,it Serie A,19,2003,9.0,23,13,9,11,3,11,18,61.1,7,17,5,12,6,29,19,0,Matches
1184,Imanol,es ESP,DF,Athletic Club,es La Liga,23,2000,5.8,7,5,1,5,1,5,18,27.8,13,6,0,6,7,14,15,0,Matches
1185,Joel Imasuen,us USA,FW,Werder Bremen,de Bundesliga,18,2004,0.0,0,0,0,0,0,0,0,,0,0,0,0,0,0,0,0,Matches
1186,Ciro Immobile,it ITA,FW,Lazio,it Serie A,33,1990,18.4,11,9,2,5,4,3,14,21.4,11,9,3,6,5,16,11,0,Matches
1187,Gino Infantino,ar ARG,MF,Fiorentina,it Serie A,20,2003,1.1,1,1,0,1,0,0,1,0.0,1,4,0,4,3,4,1,0,Matches
1188,Danny Ings,eng ENG,FW,West Ham,eng Premier League,31,1992,4.5,6,2,0,6,0,4,13,30.8,9,4,1,3,3,9,7,0,Matches
1189,Bonke Innocent,ng NGA,MF,Lorient,fr Ligue 1,27,1996,2.3,6,4,2,2,2,2,9,22.2,7,2,1,1,4,10,2,0,Matches
1190,Tim Iroegbunam,eng ENG,MF,Aston Villa,eng Premier League,20,2003,1.8,7,5,4,2,1,4,9,44.4,5,3,0,3,2,9,3,0,Matches
1191,Alexander Isak,se SWE,FW,Newcastle Utd,eng Premier League,23,1999,25.1,5,0,2,1,2,2,8,25.0,6,16,1,15,6,11,13,0,Matches
1192,Gustav Isaksen,dk DEN,FW,Lazio,it Serie A,22,2001,11.9,4,3,2,1,1,1,9,11.1,8,11,1,10,4,8,4,0,Matches
1193,Isco,es ESP,MF,Betis,es La Liga,31,1992,25.8,41,27,15,21,5,14,38,36.8,24,19,1,18,10,51,7,0,Matches
1194,Thomas Isherwood,se SWE,DF,Darmstadt 98,de Bundesliga,25,1998,7.1,11,5,7,3,1,5,9,55.6,4,10,7,3,10,21,34,0,Matches
1195,Ismaily,br BRA,DF,Lille,fr Ligue 1,33,1990,27.4,72,47,34,25,13,31,60,51.7,29,33,6,27,32,104,77,0,Matches
1196,Ardian Ismajli,al ALB,DF,Empoli,it Serie A,26,1996,22.7,26,16,18,6,2,18,23,78.3,5,28,17,11,23,49,126,1,Matches
1197,Yanis Issoufou,fr FRA,MF,Montpellier,fr Ligue 1,16,2006,0.1,0,0,0,0,0,0,0,,0,0,0,0,0,0,0,0,Matches
1198,Ko Itakura,jp JPN,"DF,MF",Gladbach,de Bundesliga,26,1997,17.7,34,21,17,15,2,16,26,61.5,10,32,18,14,22,56,62,0,Matches
1199,Hiroki Ito,jp JPN,DF,Stuttgart,de Bundesliga,24,1999,24.8,19,18,13,6,0,11,26,42.3,15,29,17,12,29,48,86,2,Matches
1200,Junya Ito,jp JPN,"FW,MF",Reims,fr Ligue 1,30,1993,30.2,33,15,11,14,8,10,36,27.8,26,23,1,22,14,47,7,0,Matches
1201,Diego Iturralde,es ESP,DF,Sevilla,es La Liga,20,2003,0.4,0,0,0,0,0,0,0,,0,1,1,0,0,0,2,0,Matches
1202,Alex Iwobi,ng NGA,MF,Everton,eng Premier League,27,1996,1.6,2,0,1,0,1,2,3,66.7,1,2,0,2,1,3,0,0,Matches
1203,Alex Iwobi,ng NGA,"FW,MF",Fulham,eng Premier League,27,1996,24.4,29,18,12,15,2,12,25,48.0,13,16,0,16,14,43,9,0,Matches
1204,Armando Izzo,it ITA,DF,Monza,it Serie A,31,1992,18.3,27,17,17,9,1,16,27,59.3,11,20,16,4,27,54,49,1,Matches
1205,Nicolas Jackson,sn SEN,FW,Chelsea,eng Premier League,22,2001,31.1,21,13,5,8,8,5,24,20.8,19,20,5,15,4,25,17,0,Matches
1206,Jérémy Jacquet,fr FRA,MF,Rennes,fr Ligue 1,18,2005,0.1,1,1,1,0,0,0,1,0.0,1,0,0,0,1,2,0,0,Matches
1207,Jérémy Jacquet,fr FRA,DF,Clermont Foot,fr Ligue 1,18,2005,2.8,4,3,4,0,0,3,3,100.0,0,7,3,4,6,10,10,0,Matches
1208,Lee Jae-sung,kr KOR,"MF,FW",Mainz 05,de Bundesliga,30,1992,23.5,33,20,11,16,6,13,39,33.3,26,22,2,20,27,60,23,0,Matches
1209,Paul Jaeckel,de GER,DF,Union Berlin,de Bundesliga,25,1998,2.6,7,2,4,3,0,5,9,55.6,4,3,2,1,4,11,7,0,Matches
1210,Filip Jagiełło,pl POL,MF,Genoa,it Serie A,25,1997,0.4,0,0,0,0,0,0,1,0.0,1,1,1,0,1,1,0,0,Matches
1211,Kristijan Jakić,hr CRO,MF,Augsburg,de Bundesliga,26,1997,11.7,28,14,14,10,4,15,33,45.5,18,13,1,12,20,48,15,0,Matches
1212,Kristijan Jakić,hr CRO,"MF,FW",Eint Frankfurt,de Bundesliga,26,1997,2.2,3,3,1,2,0,1,3,33.3,2,1,0,1,2,5,2,0,Matches
1213,Ismail Jakobs,sn SEN,DF,Monaco,fr Ligue 1,23,1999,16.3,57,41,27,21,9,29,47,61.7,18,19,2,17,11,68,40,0,Matches
1214,Ablie Jallow,gm GAM,"MF,FW",Metz,fr Ligue 1,24,1998,10.2,8,5,2,3,3,3,5,60.0,2,4,0,4,8,16,3,0,Matches
1215,Reece James,eng ENG,DF,Chelsea,eng Premier League,23,1999,4.7,14,9,10,3,1,8,10,80.0,2,4,4,0,3,17,7,1,Matches
1216,Vitaly Janelt,de GER,"MF,DF",Brentford,eng Premier League,25,1998,33.9,63,38,29,25,9,32,64,50.0,32,35,9,26,36,99,64,3,Matches
1217,Jakub Jankto,cz CZE,"MF,FW",Cagliari,it Serie A,27,1996,9.7,12,9,9,1,2,8,20,40.0,12,5,1,4,5,17,20,0,Matches
1218,Tony Jantschke,de GER,"DF,MF",Gladbach,de Bundesliga,33,1990,0.3,1,1,1,0,0,1,1,100.0,0,2,2,0,1,2,4,0,Matches
1219,Adnan Januzaj,be BEL,"FW,MF",Sevilla,es La Liga,28,1995,2.1,3,3,2,0,1,0,1,0.0,1,2,0,2,1,4,0,0,Matches
1220,Nuha Jatta,gm GAM,FW,RB Leipzig,de Bundesliga,17,2006,0.0,0,0,0,0,0,0,0,,0,0,0,0,0,0,0,0,Matches
1221,Mikel Jauregizar,es ESP,MF,Athletic Club,es La Liga,19,2003,1.7,0,0,0,0,0,0,6,0.0,6,5,0,5,0,0,2,0,Matches
1222,Luis Javier Suárez,co COL,FW,Almería,es La Liga,25,1997,10.2,7,5,2,5,0,2,6,33.3,4,11,0,11,0,7,13,0,Matches
1223,Danley Jean-Jacques,ht HAI,MF,Metz,fr Ligue 1,23,2000,29.8,54,28,24,21,9,19,56,33.9,37,48,7,41,44,98,44,0,Matches
1224,Salim El Jebari,ma MAR,MF,Atlético Madrid,es La Liga,19,2004,0.1,1,0,0,1,0,0,0,,0,0,0,0,0,1,1,0,Matches
1225,Daniel Jebbison,ca CAN,FW,Sheffield Utd,eng Premier League,19,2003,0.2,0,0,0,0,0,0,0,,0,1,0,1,0,0,0,0,Matches
1226,Jeffinho,br BRA,"FW,MF",Lyon,fr Ligue 1,23,1999,3.4,11,4,3,5,3,4,11,36.4,7,1,0,1,0,11,0,0,Matches
1227,Fredrik Jensen,fi FIN,"MF,FW",Augsburg,de Bundesliga,25,1997,14.9,23,11,9,8,6,14,28,50.0,14,30,1,29,12,35,21,0,Matches
1228,Mathias Jensen,dk DEN,MF,Brentford,eng Premier League,27,1996,24.5,54,32,25,22,7,26,95,27.4,69,41,6,35,23,77,25,1,Matches
1229,Moritz Jenz,de GER,DF,Wolfsburg,de Bundesliga,24,1999,19.4,34,24,21,11,2,14,21,66.7,7,29,17,12,26,60,94,0,Matches
1230,Gabriel Jesus,br BRA,FW,Arsenal,eng Premier League,26,1997,16.4,24,17,11,5,8,5,18,27.8,13,23,1,22,13,37,12,0,Matches
1231,Juan Jesus,br BRA,DF,Napoli,it Serie A,32,1991,23.5,42,19,28,12,2,23,33,69.7,10,23,12,11,23,65,67,1,Matches
1232,Álex Jiménez,es ESP,DF,Milan,it Serie A,18,2005,0.8,2,1,2,0,0,2,5,40.0,3,0,0,0,0,2,4,0,Matches
1233,Raúl Jiménez,mx MEX,FW,Fulham,eng Premier League,32,1991,15.5,18,12,4,8,6,7,20,35.0,13,11,3,8,4,22,13,0,Matches
1234,João Pedro,br BRA,"FW,MF",Brighton,eng Premier League,21,2001,22.7,31,14,10,13,8,14,24,58.3,10,15,2,13,11,42,28,0,Matches
1235,Joelinton,br BRA,"MF,FW",Newcastle Utd,eng Premier League,26,1996,14.2,39,27,21,15,3,14,38,36.8,24,23,7,16,19,58,11,1,Matches
1236,Ben Johnson,eng ENG,"DF,FW",West Ham,eng Premier League,23,2000,6.0,11,7,7,3,1,9,14,64.3,5,2,1,1,5,16,14,0,Matches
1237,Brennan Johnson,wls WAL,FW,Tottenham,eng Premier League,22,2001,23.2,26,15,14,5,7,12,31,38.7,19,37,1,36,10,36,12,1,Matches
1238,Brennan Johnson,wls WAL,"FW,MF",Nott'ham Forest,eng Premier League,22,2001,2.6,4,1,1,1,2,2,4,50.0,2,4,1,3,0,4,0,0,Matches
1239,Joseph Johnson,eng ENG,DF,Luton Town,eng Premier League,17,2006,0.9,0,0,0,0,0,0,1,0.0,1,0,0,0,0,0,0,0,Matches
1240,Sam Johnstone,eng ENG,GK,Crystal Palace,eng Premier League,30,1993,20.0,1,0,1,0,0,1,1,100.0,0,0,0,0,1,2,5,0,Matches
1241,Curtis Jones,eng ENG,MF,Liverpool,eng Premier League,22,2001,13.0,27,14,12,12,3,10,23,43.5,13,22,0,22,7,34,8,0,Matches
1242,Frenkie de Jong,nl NED,MF,Barcelona,es La Liga,26,1997,18.2,43,26,14,23,6,8,19,42.1,11,18,8,10,14,57,28,1,Matches
1243,Joan Jordán,es ESP,MF,Sevilla,es La Liga,29,1994,4.2,8,7,3,3,2,7,15,46.7,8,4,2,2,4,12,2,0,Matches
1244,Jordi,es ESP,"MF,DF",Getafe,es La Liga,22,2001,6.4,16,11,3,11,2,7,15,46.7,8,7,2,5,8,24,7,0,Matches
1245,Jeremy Jorge,es ESP,FW,Getafe,es La Liga,20,2003,0.0,0,0,0,0,0,0,0,,0,0,0,0,0,0,0,0,Matches
1246,Kaio Jorge,br BRA,FW,Frosinone,it Serie A,21,2002,9.0,6,4,0,1,5,3,4,75.0,1,6,0,6,1,7,0,0,Matches
1247,Jorginho,it ITA,MF,Arsenal,eng Premier League,31,1991,10.2,24,10,6,10,8,11,23,47.8,12,17,1,16,12,36,7,1,Matches
1248,Willian José,br BRA,FW,Betis,es La Liga,31,1991,21.9,7,3,1,2,4,2,5,40.0,3,8,2,6,2,9,15,0,Matches
1249,Joselu,es ESP,FW,Real Madrid,es La Liga,33,1990,18.7,6,3,1,4,1,0,7,0.0,7,11,1,10,6,12,11,0,Matches
1250,Diogo Jota,pt POR,FW,Liverpool,eng Premier League,26,1996,12.7,23,13,6,13,4,10,23,43.5,13,9,1,8,7,30,4,0,Matches
1251,Antoine Joujou,fr FRA,"FW,MF",Le Havre,fr Ligue 1,20,2003,8.7,20,12,7,7,6,11,21,52.4,10,11,2,9,7,27,5,0,Matches
1252,Luka Jović,rs SRB,FW,Milan,it Serie A,25,1997,9.7,6,4,0,3,3,4,6,66.7,2,3,0,3,1,7,9,0,Matches
1253,Kamil Jóźwiak,pl POL,MF,Granada,es La Liga,25,1998,6.3,13,10,4,6,3,9,17,52.9,8,4,0,4,2,15,6,0,Matches
1254,Juanmi,es ESP,FW,Cádiz,es La Liga,30,1993,9.7,9,4,2,7,0,2,9,22.2,7,6,0,6,6,15,3,0,Matches
1255,Juanpe,es ESP,DF,Girona,es La Liga,32,1991,8.3,11,8,8,3,0,9,10,90.0,1,17,11,6,7,18,50,1,Matches
1256,Mads Juel Andersen,dk DEN,DF,Luton Town,eng Premier League,25,1997,4.4,6,5,4,2,0,4,4,100.0,0,9,6,3,8,14,29,0,Matches
1257,Christopher Jullien,fr FRA,DF,Montpellier,fr Ligue 1,30,1993,13.7,16,12,11,5,0,6,17,35.3,11,25,20,5,12,28,106,2,Matches
1258,Anthony Jung,de GER,DF,Werder Bremen,de Bundesliga,31,1991,28.7,37,23,21,14,2,18,33,54.5,15,39,17,22,24,61,102,0,Matches
1259,Eli Junior Kroupi,fr FRA,"FW,MF",Lorient,fr Ligue 1,17,2006,12.0,7,4,2,2,3,1,9,11.1,8,6,0,6,10,17,5,0,Matches
1260,Hamed Junior Traorè,ci CIV,MF,Bournemouth,eng Premier League,23,2000,0.5,1,0,1,0,0,1,3,33.3,2,3,0,3,0,1,0,0,Matches
1261,Hamed Junior Traorè,ci CIV,MF,Napoli,it Serie A,23,2000,4.2,4,2,2,0,2,1,6,16.7,5,3,0,3,2,6,1,1,Matches
1262,Vinicius Júnior,br BRA,FW,Real Madrid,es La Liga,23,2000,20.7,18,13,5,5,8,3,12,25.0,9,13,0,13,1,19,3,2,Matches
1263,Josip Juranović,hr CRO,DF,Union Berlin,de Bundesliga,27,1995,14.4,20,14,11,7,2,10,21,47.6,11,17,3,14,12,32,27,1,Matches
1264,David Jurásek,cz CZE,DF,Hoffenheim,de Bundesliga,22,2000,5.5,14,11,13,1,0,7,17,41.2,10,7,2,5,3,17,22,1,Matches
1265,Julian Justvan,de GER,"FW,MF",Hoffenheim,de Bundesliga,25,1998,0.5,1,0,1,0,0,1,2,50.0,1,1,0,1,0,1,0,0,Matches
1266,Julian Justvan,de GER,"MF,FW",Darmstadt 98,de Bundesliga,25,1998,11.4,10,4,2,7,1,3,17,17.6,14,12,2,10,11,21,6,1,Matches
1267,Filip Jørgensen,dk DEN,GK,Villarreal,es La Liga,21,2002,36.0,3,1,3,0,0,3,4,75.0,1,0,0,0,2,5,10,3,Matches
1268,Mathias Jørgensen,dk DEN,DF,Brentford,eng Premier League,33,1990,12.1,17,12,15,1,1,11,19,57.9,8,9,5,4,12,29,40,0,Matches
1269,Mohamed Kaba,fr FRA,MF,Lecce,it Serie A,21,2001,15.3,39,23,15,16,8,17,34,50.0,17,22,4,18,12,51,13,0,Matches
1270,Sory Kaba,gn GUI,FW,Las Palmas,es La Liga,28,1995,8.0,2,0,0,2,0,0,5,0.0,5,6,0,6,0,2,9,0,Matches
1271,Ozan Kabak,tr TUR,DF,Hoffenheim,de Bundesliga,23,2000,25.4,48,35,32,14,2,19,33,57.6,14,43,21,22,46,94,106,2,Matches
1272,Christian Kabasele,be BEL,DF,Udinese,it Serie A,32,1991,9.6,10,7,4,5,1,2,11,18.2,9,15,9,6,12,22,56,0,Matches
1273,Issa Kaboré,bf BFA,DF,Luton Town,eng Premier League,22,2001,19.2,52,28,23,21,8,24,45,53.3,21,22,11,11,16,68,56,2,Matches
1274,Abdoul Kader Bamba,fr FRA,"FW,MF",Nantes,fr Ligue 1,29,1994,6.8,10,7,2,5,3,5,15,33.3,10,4,0,4,4,14,4,1,Matches
1275,Yaya Kader Fofana,ml MLI,"MF,DF",Reims,fr Ligue 1,19,2004,0.4,3,3,1,1,1,0,1,0.0,1,0,0,0,1,4,0,0,Matches
1276,Pavel Kadeřábek,cz CZE,"DF,FW",Hoffenheim,de Bundesliga,31,1992,26.8,31,19,10,15,6,18,40,45.0,22,22,8,14,23,54,68,0,Matches
1277,Tino Kadewere,zw ZIM,"FW,MF",Lyon,fr Ligue 1,27,1996,3.3,1,1,0,1,0,1,5,20.0,4,3,1,2,5,6,7,0,Matches
1278,Tino Kadewere,zw ZIM,"FW,MF",Nantes,fr Ligue 1,27,1996,8.7,9,4,3,3,3,6,11,54.5,5,10,1,9,10,19,8,0,Matches
1279,Kaiky,br BRA,DF,Almería,es La Liga,19,2004,5.8,7,4,6,0,1,3,6,50.0,3,9,7,2,3,10,29,1,Matches
1280,Florian Kainz,at AUT,"MF,FW",Köln,de Bundesliga,30,1992,24.4,28,20,8,13,7,17,39,43.6,22,20,6,14,13,41,23,1,Matches
1281,Sasa Kalajdzic,at AUT,FW,Wolves,eng Premier League,26,1997,1.8,6,2,3,2,1,1,2,50.0,1,3,0,3,1,7,6,0,Matches
1282,Sasa Kalajdzic,at AUT,FW,Eint Frankfurt,de Bundesliga,26,1997,3.6,2,2,0,2,0,0,0,,0,2,2,0,2,4,6,0,Matches
1283,Arnaud Kalimuendo,fr FRA,FW,Rennes,fr Ligue 1,21,2002,23.8,5,4,2,2,1,2,5,40.0,3,13,2,11,4,9,4,0,Matches
1284,Yayah Kallon,sl SLE,FW,Hellas Verona,it Serie A,22,2001,0.0,0,0,0,0,0,0,0,,0,0,0,0,0,0,0,0,Matches
1285,Gedeon Kalulu,cd COD,DF,Lorient,fr Ligue 1,25,1997,10.8,23,17,13,8,2,12,22,54.5,10,18,2,16,5,28,30,0,Matches
1286,Pierre Kalulu,fr FRA,DF,Milan,it Serie A,23,2000,4.2,5,1,2,3,0,1,2,50.0,1,4,3,1,1,6,12,1,Matches
1287,Daichi Kamada,jp JPN,MF,Lazio,it Serie A,26,1996,17.2,53,36,22,22,9,28,52,53.8,24,24,5,19,18,71,7,0,Matches
1288,Warren Kamanzi,no NOR,"DF,FW",Toulouse,fr Ligue 1,22,2000,13.2,36,24,16,16,4,13,23,56.5,10,11,3,8,9,45,35,0,Matches
1289,Boubacar Kamara,fr FRA,MF,Aston Villa,eng Premier League,23,1999,18.4,43,29,16,21,6,24,47,51.1,23,21,7,14,21,64,16,0,Matches
1290,Hassane Kamara,ci CIV,DF,Udinese,it Serie A,29,1994,24.7,45,32,26,13,6,25,38,65.8,13,29,2,27,26,71,66,0,Matches
1291,Willy Kambwala,fr FRA,DF,Manchester Utd,eng Premier League,18,2004,3.7,3,1,1,2,0,1,3,33.3,2,6,3,3,4,7,14,1,Matches
1292,Jakub Kamiński,pl POL,"FW,MF",Wolfsburg,de Bundesliga,21,2002,5.3,14,5,12,2,0,3,6,50.0,3,3,0,3,2,16,5,0,Matches
1293,Thomas Kaminski,be BEL,GK,Luton Town,eng Premier League,30,1992,37.8,2,1,2,0,0,2,6,33.3,4,1,0,1,0,2,14,2,Matches
1294,Kevin Kampl,si SVN,MF,RB Leipzig,de Bundesliga,32,1990,15.1,19,8,8,9,2,10,21,47.6,11,19,7,12,11,30,14,1,Matches
1295,Harry Kane,eng ENG,FW,Bayern Munich,de Bundesliga,30,1993,31.5,13,9,4,4,5,6,18,33.3,12,12,4,8,6,19,14,0,Matches
1296,Lee Kang-in,kr KOR,"FW,MF",Paris S-G,fr Ligue 1,22,2001,16.3,26,13,7,9,10,15,36,41.7,21,7,0,7,6,32,3,0,Matches
1297,Yann Karamoh,fr FRA,"MF,FW",Torino,it Serie A,25,1998,1.8,1,0,0,0,1,0,0,,0,0,0,0,0,1,1,0,Matches
1298,Yann Karamoh,fr FRA,"FW,MF",Montpellier,fr Ligue 1,25,1998,3.2,1,0,0,0,1,1,2,50.0,1,3,0,3,0,1,0,0,Matches
1299,Atakan Karazor,,MF,Stuttgart,de Bundesliga,26,1996,29.1,72,44,23,38,11,29,60,48.3,31,37,8,29,27,99,43,0,Matches
1300,Ayman Kari,fr FRA,MF,Lorient,fr Ligue 1,18,2004,9.9,18,14,9,9,0,12,19,63.2,7,19,2,17,6,24,9,1,Matches
1301,Emir Karic,at AUT,DF,Darmstadt 98,de Bundesliga,26,1997,19.8,45,27,23,14,8,21,33,63.6,12,42,11,31,13,58,43,0,Matches
1302,Loris Karius,de GER,GK,Newcastle Utd,eng Premier League,30,1993,1.0,0,0,0,0,0,0,0,,0,0,0,0,0,0,1,0,Matches
1303,Jesper Karlsson,se SWE,FW,Bologna,it Serie A,25,1998,3.8,3,3,2,1,0,2,8,25.0,6,4,0,4,4,7,1,0,Matches
1304,Jon Karrikaburu,es ESP,"MF,FW",Alavés,es La Liga,20,2002,0.2,0,0,0,0,0,0,0,,0,0,0,0,0,0,0,0,Matches
1305,Rick Karsdorp,nl NED,DF,Roma,it Serie A,28,1995,13.2,25,18,11,8,6,16,24,66.7,8,13,4,9,9,34,16,0,Matches
1306,Grigoris Kastanos,cy CYP,"MF,DF",Salernitana,it Serie A,25,1998,16.4,23,14,8,9,6,9,20,45.0,11,13,4,9,8,31,9,0,Matches
1307,Silas Katompa,cd COD,"FW,MF",Stuttgart,de Bundesliga,24,1998,10.0,5,3,3,2,0,3,12,25.0,9,9,0,9,0,5,4,0,Matches
1308,Panos Katseris,gr GRE,DF,Lorient,fr Ligue 1,22,2001,11.6,26,20,16,8,2,16,25,64.0,9,20,4,16,8,34,18,0,Matches
1309,Mikkel Kaufmann,dk DEN,FW,Union Berlin,de Bundesliga,22,2001,5.4,6,3,2,3,1,3,10,30.0,7,12,0,12,1,7,4,0,Matches
1310,Michael Kayode,it ITA,DF,Fiorentina,it Serie A,19,2004,22.9,53,30,27,15,11,35,48,72.9,13,25,12,13,18,71,46,2,Matches
1311,Moise Kean,it ITA,FW,Juventus,it Serie A,23,2000,7.3,7,4,3,2,2,1,3,33.3,2,4,1,3,2,9,5,0,Matches
1312,Michael Keane,eng ENG,DF,Everton,eng Premier League,30,1993,4.9,7,3,3,3,1,1,7,14.3,6,5,4,1,5,12,18,1,Matches
1313,Ibrahima Kebe,ml MLI,MF,Girona,es La Liga,22,2000,0.1,1,1,0,1,0,0,0,,0,1,0,1,1,2,0,0,Matches
1314,Kévin Keben Biakolo,cm CMR,DF,Toulouse,fr Ligue 1,19,2004,5.8,4,2,4,0,0,3,6,50.0,3,7,0,7,8,12,17,0,Matches
1315,Yassine Kechta,ma MAR,MF,Le Havre,fr Ligue 1,21,2002,20.5,46,24,24,19,3,31,73,42.5,42,20,3,17,23,69,16,1,Matches
1316,Thilo Kehrer,de GER,"DF,MF",West Ham,eng Premier League,26,1996,0.2,1,1,0,1,0,0,0,,0,2,2,0,0,1,0,0,Matches
1317,Thilo Kehrer,de GER,DF,Monaco,fr Ligue 1,26,1996,14.7,32,22,22,7,3,22,39,56.4,17,18,6,12,30,62,55,0,Matches
1318,Habib Keita,ml MLI,MF,Clermont Foot,fr Ligue 1,21,2002,14.2,34,19,14,15,5,17,28,60.7,11,27,10,17,29,63,30,0,Matches
1319,Naby Keïta,gn GUI,"MF,DF",Werder Bremen,de Bundesliga,28,1995,1.2,1,1,1,0,0,0,1,0.0,1,2,0,2,2,3,1,0,Matches
1320,Yannik Keitel,de GER,"DF,MF",Freiburg,de Bundesliga,23,2000,10.2,20,15,14,5,1,10,15,66.7,5,17,8,9,12,32,44,3,Matches
1321,Caoimhín Kelleher,ie IRL,GK,Liverpool,eng Premier League,24,1998,10.0,0,0,0,0,0,0,0,,0,0,0,0,0,0,4,1,Matches
1322,Thomas Keller,de GER,"MF,FW",Heidenheim,de Bundesliga,23,1999,0.0,0,0,0,0,0,0,0,,0,0,0,0,0,0,0,0,Matches
1323,Lloyd Kelly,eng ENG,DF,Bournemouth,eng Premier League,24,1998,17.3,24,19,10,9,5,14,25,56.0,11,22,12,10,13,37,67,0,Matches
1324,Omari Kellyman,eng ENG,FW,Aston Villa,eng Premier League,17,2005,0.4,1,0,0,1,0,1,2,50.0,1,0,0,0,0,1,0,0,Matches
1325,Aljoscha Kemlein,de GER,MF,Union Berlin,de Bundesliga,18,2004,0.3,0,0,0,0,0,0,3,0.0,3,1,0,1,0,0,0,0,Matches
1326,Tobias Kempe,de GER,MF,Darmstadt 98,de Bundesliga,34,1989,15.0,20,13,9,8,3,8,24,33.3,16,16,4,12,9,29,12,0,Matches
1327,Milos Kerkez,hu HUN,DF,Bournemouth,eng Premier League,19,2003,21.9,47,26,31,13,3,30,42,71.4,12,31,11,20,20,67,60,2,Matches
1328,Kaine Kesler-Hayden,eng ENG,"MF,DF",Aston Villa,eng Premier League,20,2002,0.1,0,0,0,0,0,0,0,,0,0,0,0,0,0,0,0,Matches
1329,Reda Khadra,de GER,"FW,MF",Reims,fr Ligue 1,22,2001,15.2,16,10,5,4,7,8,20,40.0,12,8,2,6,3,19,13,0,Matches
1330,Wahbi Khazri,tn TUN,FW,Montpellier,fr Ligue 1,32,1991,12.6,24,17,8,12,4,14,35,40.0,21,10,0,10,3,27,7,0,Matches
1331,Rani Khedira,de GER,MF,Union Berlin,de Bundesliga,29,1994,14.9,35,22,15,19,1,17,26,65.4,9,12,5,7,22,57,38,0,Matches
1332,Abdukodir Khusanov,uz UZB,DF,Lens,fr Ligue 1,19,2004,9.0,21,12,13,8,0,9,17,52.9,8,13,8,5,13,34,32,2,Matches
1333,Kiké,es ESP,"FW,MF",Alavés,es La Liga,33,1989,15.8,8,4,2,3,3,4,9,44.4,5,16,5,11,1,9,12,0,Matches
1334,Luca Kilian,de GER,DF,Köln,de Bundesliga,23,1999,7.1,16,9,15,1,0,9,14,64.3,5,12,5,7,7,23,28,0,Matches
1335,Max Kilman,eng ENG,DF,Wolves,eng Premier League,26,1997,38.0,47,21,40,6,1,24,32,75.0,8,64,37,27,39,86,182,4,Matches
1336,Joshua Kimmich,de GER,"MF,DF",Bayern Munich,de Bundesliga,28,1995,24.2,45,33,25,15,5,26,39,66.7,13,32,4,28,14,59,28,1,Matches
1337,Jakub Kiwior,pl POL,DF,Arsenal,eng Premier League,23,2000,10.5,20,12,11,8,1,14,19,73.7,5,11,3,8,8,28,28,1,Matches
1338,Simon Kjær,dk DEN,DF,Milan,it Serie A,34,1989,13.0,24,15,11,11,2,14,22,63.6,8,22,16,6,14,38,46,2,Matches
1339,Davy Klaassen,nl NED,MF,Inter,it Serie A,30,1993,2.3,4,2,0,4,0,1,3,33.3,2,5,1,4,3,7,4,0,Matches
1340,Christoph Klarer,at AUT,DF,Darmstadt 98,de Bundesliga,23,2000,26.2,37,22,30,4,3,24,36,66.7,12,31,20,11,21,58,94,1,Matches
1341,Tim Kleindienst,de GER,FW,Heidenheim,de Bundesliga,27,1995,31.9,21,12,6,11,4,7,25,28.0,18,32,8,24,12,33,58,0,Matches
1342,Lukas Klostermann,de GER,DF,RB Leipzig,de Bundesliga,27,1996,16.0,15,10,7,7,1,4,13,30.8,9,25,12,13,13,28,64,1,Matches
1343,Justin Kluivert,nl NED,"MF,FW",Bournemouth,eng Premier League,24,1999,21.3,28,14,5,12,11,8,30,26.7,22,16,1,15,8,36,11,0,Matches
1344,Ansgar Knauff,de GER,"MF,DF",Eint Frankfurt,de Bundesliga,21,2002,23.4,43,26,17,16,10,17,31,54.8,14,40,3,37,20,63,15,0,Matches
1345,Robin Knoche,de GER,DF,Union Berlin,de Bundesliga,31,1992,21.3,34,22,27,7,0,19,30,63.3,11,27,19,8,13,47,73,0,Matches
1346,Gregor Kobel,ch SUI,GK,Dortmund,de Bundesliga,25,1997,26.3,0,0,0,0,0,0,1,0.0,1,0,0,0,0,0,11,0,Matches
1347,Robin Koch,de GER,DF,Eint Frankfurt,de Bundesliga,27,1996,30.4,38,23,26,12,0,17,27,63.0,10,33,24,9,32,70,136,2,Matches
1348,Philipp Köhn,ch SUI,GK,Monaco,fr Ligue 1,25,1998,22.0,1,1,1,0,0,1,1,100.0,0,0,0,0,1,2,5,3,Matches
1349,Dominik Kohr,de GER,"DF,MF",Mainz 05,de Bundesliga,29,1994,24.3,65,42,36,25,4,36,57,63.2,21,27,6,21,43,108,58,0,Matches
1350,Koke,es ESP,MF,Atlético Madrid,es La Liga,31,1992,27.7,66,44,27,32,7,36,79,45.6,43,37,12,25,16,82,34,1,Matches
1351,Sead Kolašinac,ba BIH,DF,Atalanta,it Serie A,30,1993,24.2,44,32,23,19,2,30,49,61.2,19,22,9,13,21,65,47,0,Matches
1352,Luca Koleosho,it ITA,"MF,FW",Burnley,eng Premier League,18,2004,10.8,7,4,2,5,0,2,10,20.0,8,13,0,13,2,9,0,0,Matches
1353,Randal Kolo Muani,fr FRA,"FW,MF",Paris S-G,fr Ligue 1,24,1998,14.1,10,8,5,3,2,5,13,38.5,8,5,0,5,4,14,10,0,Matches
1354,Randal Kolo Muani,fr FRA,FW,Eint Frankfurt,de Bundesliga,24,1998,1.7,0,0,0,0,0,0,0,,0,0,0,0,0,0,1,0,Matches
1355,Mert Kömür,de GER,"MF,DF",Augsburg,de Bundesliga,18,2005,1.3,3,3,3,0,0,3,5,60.0,2,0,0,0,0,3,1,0,Matches
1356,Cheick Konaté,ml MLI,DF,Clermont Foot,fr Ligue 1,19,2004,11.9,26,15,17,9,0,20,36,55.6,16,16,2,14,13,39,21,0,Matches
1357,Ibrahima Konaté,fr FRA,DF,Liverpool,eng Premier League,24,1999,17.5,36,22,22,13,1,18,24,75.0,6,18,12,6,20,56,51,1,Matches
1358,Geoffrey Kondogbia,cf CTA,MF,Marseille,fr Ligue 1,30,1993,16.3,48,31,18,25,5,13,32,40.6,19,21,4,17,30,78,25,0,Matches
1359,Abdoul Koné,fr FRA,DF,Reims,fr Ligue 1,18,2005,2.1,7,7,5,2,0,4,11,36.4,7,2,0,2,2,9,9,0,Matches
1360,Amadou Koné,ml MLI,MF,Reims,fr Ligue 1,18,2005,5.3,13,8,11,2,0,6,10,60.0,4,8,3,5,10,23,10,0,Matches
1361,Ibrahima Koné,ml MLI,FW,Almería,es La Liga,24,1999,3.1,1,0,1,0,0,1,1,100.0,0,1,0,1,0,1,4,0,Matches
1362,Ibrahima Koné,ml MLI,FW,Lorient,fr Ligue 1,24,1999,0.4,0,0,0,0,0,0,1,0.0,1,0,0,0,0,0,0,0,Matches
1363,Manu Koné,fr FRA,MF,Gladbach,de Bundesliga,22,2001,17.3,45,26,20,20,5,17,25,68.0,8,22,1,21,15,60,16,1,Matches
1364,Ezri Konsa,eng ENG,DF,Aston Villa,eng Premier League,25,1997,34.1,54,32,28,23,3,23,27,85.2,4,36,20,16,28,82,73,3,Matches
1365,Teun Koopmeiners,nl NED,MF,Atalanta,it Serie A,25,1998,29.2,39,24,12,22,5,17,50,34.0,33,33,3,30,10,49,35,0,Matches
1366,Odilon Kossounou,ci CIV,DF,Leverkusen,de Bundesliga,22,2001,20.1,30,20,11,12,7,15,26,57.7,11,27,3,24,27,57,43,1,Matches
1367,Filip Kostić,rs SRB,DF,Juventus,it Serie A,30,1992,20.2,37,23,20,13,4,17,33,51.5,16,29,8,21,9,46,43,0,Matches
1368,N'Guessan Kouadio,ci CIV,"MF,FW",Metz,fr Ligue 1,20,2003,1.2,3,1,0,3,0,0,3,0.0,3,3,0,3,1,4,0,0,Matches
1369,Christian Kouamé,ci CIV,FW,Fiorentina,it Serie A,25,1997,12.1,13,4,7,6,0,6,10,60.0,4,16,0,16,2,15,10,0,Matches
1370,Rominigue Kouamé,ml MLI,MF,Cádiz,es La Liga,26,1996,9.1,14,9,6,7,1,7,15,46.7,8,10,2,8,13,27,10,1,Matches
1371,Koffi Kouao,ci CIV,DF,Metz,fr Ligue 1,25,1998,9.6,20,13,12,7,1,11,17,64.7,6,9,6,3,13,33,38,1,Matches
1372,Tomáš Koubek,cz CZE,GK,Augsburg,de Bundesliga,30,1992,3.0,0,0,0,0,0,0,0,,0,0,0,0,0,0,1,1,Matches
1373,Therence Koudou,fr FRA,DF,Reims,fr Ligue 1,18,2004,3.5,2,2,1,1,0,0,2,0.0,2,4,3,1,4,6,9,0,Matches
1374,Jules Koundé,fr FRA,DF,Barcelona,es La Liga,24,1998,32.2,37,23,22,10,5,28,51,54.9,23,32,12,20,25,62,83,5,Matches
1375,Boubakar Kouyaté,ml MLI,DF,Montpellier,fr Ligue 1,26,1997,21.4,49,30,39,8,2,28,51,54.9,23,31,20,11,29,78,123,1,Matches
1376,Cheikhou Kouyaté,sn SEN,MF,Nott'ham Forest,eng Premier League,33,1989,2.4,8,5,3,3,2,1,4,25.0,3,4,1,3,2,10,10,0,Matches
1377,Mateo Kovačić,hr CRO,MF,Manchester City,eng Premier League,29,1994,17.2,36,25,16,15,5,18,28,64.3,10,23,1,22,10,46,10,0,Matches
1378,Viktor Kovalenko,ua UKR,MF,Empoli,it Serie A,27,1996,6.8,5,2,2,2,1,2,8,25.0,6,12,2,10,1,6,7,0,Matches
1379,Matej Kovar,cz CZE,GK,Leverkusen,de Bundesliga,23,2000,1.0,0,0,0,0,0,0,0,,0,0,0,0,0,0,0,0,Matches
1380,Dawid Kownacki,pl POL,FW,Werder Bremen,de Bundesliga,26,1997,4.2,1,1,1,0,0,1,4,25.0,3,3,1,2,0,1,1,0,Matches
1381,Emil Krafth,se SWE,DF,Newcastle Utd,eng Premier League,28,1994,10.1,21,14,10,7,4,12,25,48.0,13,8,3,5,9,30,21,0,Matches
1382,Alex Král,cz CZE,MF,Union Berlin,de Bundesliga,25,1998,15.2,19,14,7,10,2,8,20,40.0,12,15,4,11,11,30,30,0,Matches
1383,Andrej Kramarić,hr CRO,"MF,FW",Hoffenheim,de Bundesliga,32,1991,24.4,11,2,5,4,2,6,13,46.2,7,14,2,12,10,21,12,2,Matches
1384,Christoph Kramer,de GER,MF,Gladbach,de Bundesliga,32,1991,2.8,10,5,5,5,0,2,14,14.3,12,7,1,6,4,14,6,0,Matches
1385,Frans Krätzig,de GER,DF,Bayern Munich,de Bundesliga,20,2003,0.6,2,0,2,0,0,1,2,50.0,1,0,0,0,0,2,0,0,Matches
1386,Tom Krauß,de GER,MF,Mainz 05,de Bundesliga,22,2001,15.0,57,33,22,31,4,21,58,36.2,37,33,4,29,17,74,28,0,Matches
1387,Rasmus Kristensen,dk DEN,DF,Roma,it Serie A,26,1997,19.4,36,19,25,8,3,28,50,56.0,22,27,7,20,8,44,50,0,Matches
1388,Thomas Kristensen,dk DEN,DF,Udinese,it Serie A,21,2002,23.3,35,24,25,10,0,21,33,63.6,12,29,20,9,29,64,118,0,Matches
1389,Toni Kroos,de GER,MF,Real Madrid,es La Liga,33,1990,23.6,53,34,19,25,9,24,59,40.7,35,22,4,18,17,70,11,1,Matches
1390,Nikola Krstović,me MNE,FW,Lecce,it Serie A,23,2000,26.4,17,6,3,9,5,6,10,60.0,4,12,4,8,4,21,22,0,Matches
1391,Rade Krunić,ba BIH,MF,Milan,it Serie A,29,1993,7.6,10,8,3,6,1,4,9,44.4,5,7,3,4,11,21,14,0,Matches
1392,Lukas Kübler,de GER,DF,Freiburg,de Bundesliga,30,1992,20.5,50,24,35,13,2,26,42,61.9,16,36,14,22,37,87,57,1,Matches
1393,Takefusa Kubo,jp JPN,"FW,MF",Real Sociedad,es La Liga,22,2001,23.9,26,17,15,6,5,9,23,39.1,14,21,2,19,11,37,8,1,Matches
1394,Mahmut Kücüksahin,,MF,Augsburg,de Bundesliga,19,2004,0.0,0,0,0,0,0,0,0,,0,0,0,0,0,0,0,0,Matches
1395,Mohammed Kudus,gh GHA,"FW,MF",West Ham,eng Premier League,22,2000,27.6,65,47,27,27,11,20,40,50.0,20,25,0,25,11,76,9,1,Matches
1396,Christian Kühlwetter,de GER,MF,Heidenheim,de Bundesliga,27,1996,0.1,0,0,0,0,0,0,0,,0,0,0,0,0,0,0,0,Matches
1397,Dejan Kulusevski,se SWE,"FW,MF",Tottenham,eng Premier League,23,2000,30.7,62,33,19,20,23,25,67,37.3,42,24,1,23,18,80,2,1,Matches
1398,Sael Kumbedi,fr FRA,DF,Lyon,fr Ligue 1,18,2005,10.3,30,20,14,12,4,9,22,40.9,13,12,3,9,14,44,18,2,Matches
1399,Marash Kumbulla,al ALB,DF,Sassuolo,it Serie A,23,2000,4.0,3,2,2,1,0,1,2,50.0,1,8,6,2,0,3,22,0,Matches
1400,Justin Kumi,it ITA,FW,Sassuolo,it Serie A,19,2004,0.0,0,0,0,0,0,0,0,,0,0,0,0,0,0,0,0,Matches
1401,Layvin Kurzawa,fr FRA,DF,Paris S-G,fr Ligue 1,30,1992,0.1,0,0,0,0,0,0,0,,0,0,0,0,0,0,0,0,Matches
1402,Berkan Kutlu,tr TUR,MF,Genoa,it Serie A,25,1998,2.2,6,4,5,1,0,3,6,50.0,3,3,0,3,4,10,5,0,Matches
1403,Daler Kuzyaev,ru RUS,MF,Le Havre,fr Ligue 1,30,1993,23.2,34,19,11,13,10,15,43,34.9,28,18,5,13,22,56,18,1,Matches
1404,Khvicha Kvaratskhelia,ge GEO,FW,Napoli,it Serie A,22,2001,30.4,42,21,11,19,12,15,49,30.6,34,15,1,14,13,55,9,0,Matches
1405,Giorgi Kvernadze,ge GEO,"FW,DF",Frosinone,it Serie A,20,2003,0.7,3,0,2,0,1,2,2,100.0,0,1,0,1,1,4,0,0,Matches
1406,Moritz-Broni Kwarteng,gh GHA,FW,Bochum,de Bundesliga,25,1998,3.1,3,0,0,3,0,1,7,14.3,6,4,0,4,2,5,0,0,Matches
1407,Grejohn Kyei,fr FRA,FW,Clermont Foot,fr Ligue 1,27,1995,11.4,6,4,2,2,2,2,3,66.7,1,5,1,4,1,7,10,0,Matches
1408,Giorgos Kyriakopoulos,gr GRE,DF,Monza,it Serie A,27,1996,19.0,19,10,16,3,0,11,24,45.8,13,18,1,17,13,32,28,0,Matches
1409,Luca de la Torre,us USA,MF,Celta Vigo,es La Liga,25,1998,21.7,39,21,12,22,5,22,43,51.2,21,23,4,19,12,51,17,0,Matches
1410,Gaëtan Laborde,fr FRA,"FW,MF",Nice,fr Ligue 1,29,1994,21.2,18,12,8,4,6,11,30,36.7,19,20,2,18,6,24,8,1,Matches
1411,Alexandre Lacazette,fr FRA,FW,Lyon,fr Ligue 1,32,1991,25.5,19,12,8,9,2,5,17,29.4,12,22,3,19,8,27,9,0,Matches
1412,Maxence Lacroix,fr FRA,DF,Wolfsburg,de Bundesliga,23,2000,26.2,48,29,28,18,2,29,41,70.7,12,35,12,23,24,72,121,0,Matches
1413,Alban Lafont,fr FRA,GK,Nantes,fr Ligue 1,24,1999,27.7,0,0,0,0,0,0,2,0.0,2,0,0,0,0,0,14,0,Matches
1414,Yoel Lago,es ESP,DF,Celta Vigo,es La Liga,19,2004,1.0,2,0,2,0,0,0,0,,0,1,0,1,0,2,2,0,Matches
1415,Aïssa Laïdouni,tn TUN,MF,Union Berlin,de Bundesliga,26,1996,11.9,21,12,4,12,5,4,12,33.3,8,26,2,24,12,33,14,2,Matches
1416,Konrad Laimer,at AUT,"DF,MF",Bayern Munich,de Bundesliga,26,1997,19.7,56,36,25,20,11,22,52,42.3,30,42,6,36,18,74,13,2,Matches
1417,Stefan Lainer,at AUT,"DF,MF",Gladbach,de Bundesliga,30,1992,8.3,23,16,15,8,0,14,24,58.3,10,13,6,7,5,28,28,0,Matches
1418,Kenny Lala,mg MAD,DF,Brest,fr Ligue 1,31,1991,33.0,78,51,39,28,11,30,56,53.6,26,27,6,21,28,106,75,1,Matches
1419,Adam Lallana,eng ENG,"MF,FW",Brighton,eng Premier League,35,1988,9.4,8,3,4,4,0,0,4,0.0,4,2,1,1,3,11,1,0,Matches
1420,Mathis Lambourde,fr FRA,FW,Rennes,fr Ligue 1,17,2006,0.1,0,0,0,0,0,0,1,0.0,1,1,0,1,0,0,1,0,Matches
1421,Érik Lamela,ar ARG,"FW,MF",Sevilla,es La Liga,31,1992,5.1,21,14,4,10,7,10,15,66.7,5,12,0,12,1,22,5,0,Matches
1422,Mohamed Lamine Bayo,gn GUI,FW,Le Havre,fr Ligue 1,25,1998,15.4,13,5,2,5,6,2,10,20.0,8,8,1,7,2,15,11,0,Matches
1423,Didier Lamkel Zé,cm CMR,"FW,MF",Metz,fr Ligue 1,26,1996,6.1,7,2,2,4,1,2,5,40.0,3,4,0,4,0,7,11,0,Matches
1424,Tariq Lamptey,gh GHA,"DF,FW",Brighton,eng Premier League,22,2000,10.2,21,14,14,5,2,13,22,59.1,9,7,3,4,6,27,6,0,Matches
1425,Bruno Langa,mz MOZ,DF,Almería,es La Liga,25,1997,9.1,17,12,10,5,2,6,14,42.9,8,11,4,7,4,21,33,2,Matches
1426,Gianluca Lapadula,pe PER,FW,Cagliari,it Serie A,33,1990,13.4,1,1,0,0,1,1,10,10.0,9,2,1,1,2,3,5,0,Matches
1427,Aymeric Laporte,es ESP,DF,Manchester City,eng Premier League,29,1994,0.1,0,0,0,0,0,0,0,,0,1,1,0,0,0,1,0,Matches
1428,Julien Laporte,fr FRA,DF,Lorient,fr Ligue 1,29,1993,20.2,23,14,15,7,1,16,36,44.4,20,36,26,10,11,34,116,1,Matches
1429,Cyle Larin,ca CAN,FW,Mallorca,es La Liga,28,1995,20.3,17,8,6,4,7,2,7,28.6,5,16,5,11,3,20,17,0,Matches
1430,Yasser Larouci,dz ALG,DF,Sheffield Utd,eng Premier League,22,2001,5.9,17,9,10,5,2,10,14,71.4,4,6,1,5,7,24,20,1,Matches
1431,Hugo Larsson,se SWE,MF,Eint Frankfurt,de Bundesliga,19,2004,21.0,32,18,18,10,4,15,28,53.6,13,34,7,27,29,61,30,1,Matches
1432,Jamaal Lascelles,eng ENG,DF,Newcastle Utd,eng Premier League,29,1993,12.0,14,9,7,7,0,6,11,54.5,5,17,12,5,5,19,42,0,Matches
1433,Juanmi Latasa,es ESP,FW,Getafe,es La Liga,22,2001,17.3,9,7,0,6,3,1,11,9.1,10,9,0,9,4,13,21,0,Matches
1434,Toni Lato,es ESP,DF,Mallorca,es La Liga,25,1997,17.2,38,23,19,13,6,16,27,59.3,11,17,3,14,17,55,27,0,Matches
1435,Armand Lauriente,fr FRA,FW,Sassuolo,it Serie A,24,1998,32.3,31,20,8,14,9,13,44,29.5,31,29,4,25,15,46,11,0,Matches
1436,Roméo Lavia,be BEL,MF,Chelsea,eng Premier League,19,2004,0.4,1,0,0,1,0,0,0,,0,0,0,0,0,1,1,0,Matches
1437,Lázaro,br BRA,"FW,MF",Almería,es La Liga,21,2002,3.2,4,1,2,0,2,2,8,25.0,6,4,0,4,1,5,1,0,Matches
1438,Valentino Lazaro,at AUT,"DF,MF",Torino,it Serie A,27,1996,22.2,18,11,7,9,2,13,19,68.4,6,14,1,13,8,26,29,0,Matches
1439,Darko Lazović,rs SRB,"FW,MF",Hellas Verona,it Serie A,32,1990,21.4,26,16,11,6,9,16,31,51.6,15,10,1,9,6,32,14,0,Matches
1440,Manuel Lazzari,it ITA,DF,Lazio,it Serie A,29,1993,18.6,26,18,13,10,3,18,28,64.3,10,20,4,16,12,38,37,1,Matches
1441,Théo Le Bris,fr FRA,"DF,MF",Lorient,fr Ligue 1,20,2002,16.8,35,22,25,7,3,19,40,47.5,21,24,3,21,12,47,42,0,Matches
1442,Julien Le Cardinal,fr FRA,DF,Brest,fr Ligue 1,25,1997,5.3,19,11,11,7,1,8,12,66.7,4,6,3,3,13,32,26,0,Matches
1443,Julien Le Cardinal,fr FRA,DF,Lens,fr Ligue 1,25,1997,0.6,6,2,4,2,0,4,9,44.4,5,2,1,1,0,6,0,0,Matches
1444,Jérémy Le Douaron,fr FRA,FW,Brest,fr Ligue 1,25,1998,18.0,21,10,7,9,5,11,26,42.3,15,14,1,13,2,23,10,0,Matches
1445,Enzo Le Fée,fr FRA,MF,Rennes,fr Ligue 1,23,2000,17.0,50,35,23,17,10,23,47,48.9,24,17,3,14,19,69,20,0,Matches
1446,Vincent Le Goff,fr FRA,"DF,MF",Lorient,fr Ligue 1,33,1989,6.0,5,0,4,0,1,4,8,50.0,4,11,3,8,3,8,10,0,Matches
1447,Robin Le Normand,es ESP,DF,Real Sociedad,es La Liga,26,1996,27.4,31,22,16,15,0,17,30,56.7,13,26,15,11,28,59,96,1,Matches
1448,Nicola Leali,it ITA,GK,Genoa,it Serie A,30,1993,2.0,0,0,0,0,0,0,0,,0,0,0,0,0,0,0,0,Matches
1449,Rafael Leão,pt POR,FW,Milan,it Serie A,24,1999,27.9,16,10,3,8,5,8,13,61.5,5,15,1,14,9,25,19,0,Matches
1450,Adrien Lebeau,fr FRA,"MF,FW",Brest,fr Ligue 1,24,1999,0.6,0,0,0,0,0,0,3,0.0,3,2,1,1,0,0,1,0,Matches
1451,Jean-Louis Leca,fr FRA,GK,Lens,fr Ligue 1,37,1985,1.0,0,0,0,0,0,0,0,,0,0,0,0,0,0,1,0,Matches
1452,Benjamin Lecomte,fr FRA,GK,Montpellier,fr Ligue 1,32,1991,30.0,0,0,0,0,0,0,1,0.0,1,0,0,0,0,0,16,1,Matches
1453,Jeremías Ledesma,ar ARG,GK,Cádiz,es La Liga,30,1993,33.9,1,1,1,0,0,1,4,25.0,3,0,0,0,0,1,15,3,Matches
1454,Pierre Lees-Melou,fr FRA,MF,Brest,fr Ligue 1,30,1993,28.0,96,67,51,41,4,49,129,38.0,80,61,11,50,43,139,64,3,Matches
1455,Diogo Leite,pt POR,DF,Union Berlin,de Bundesliga,24,1999,30.0,52,36,31,15,6,25,51,49.0,26,48,22,26,47,99,155,1,Matches
1456,Maxim Leitsch,de GER,DF,Mainz 05,de Bundesliga,25,1998,4.2,6,3,5,1,0,3,6,50.0,3,2,0,2,4,10,13,0,Matches
1457,Florian Lejeune,fr FRA,DF,Rayo Vallecano,es La Liga,32,1991,37.0,39,25,26,11,2,19,30,63.3,11,33,18,15,23,62,155,1,Matches
1458,Stefan Lekovic,rs SRB,DF,Villarreal,es La Liga,19,2004,0.3,0,0,0,0,0,0,0,,0,1,1,0,0,0,1,0,Matches
1459,Iñigo Lekue,es ESP,DF,Athletic Club,es La Liga,30,1993,22.2,40,22,25,10,5,27,53,50.9,26,24,6,18,15,55,50,0,Matches
1460,Thomas Lemar,fr FRA,MF,Atlético Madrid,es La Liga,27,1995,1.8,3,1,2,1,0,1,2,50.0,1,0,0,0,0,3,0,0,Matches
1461,Mario Lemina,ga GAB,MF,Wolves,eng Premier League,29,1993,33.0,90,58,46,33,11,25,47,53.2,22,36,9,27,41,131,64,0,Matches
1462,Álvaro Lemos,es ESP,DF,Las Palmas,es La Liga,30,1993,2.8,4,1,1,3,0,0,2,0.0,2,3,1,2,2,6,4,0,Matches
1463,Ruben Lendinez,es ESP,DF,Valencia,es La Liga,20,2003,0.1,2,2,0,2,0,1,1,100.0,0,0,0,0,0,2,1,0,Matches
1464,Clément Lenglet,fr FRA,DF,Aston Villa,eng Premier League,28,1995,12.8,13,9,7,5,1,7,13,53.8,6,19,11,8,7,20,47,1,Matches
1465,Bernd Leno,de GER,GK,Fulham,eng Premier League,31,1992,38.0,0,0,0,0,0,0,0,,0,0,0,0,0,0,14,1,Matches
1466,Christopher Lenz,de GER,"DF,MF",RB Leipzig,de Bundesliga,28,1994,0.5,2,1,2,0,0,1,1,100.0,0,0,0,0,2,4,2,0,Matches
1467,Christopher Lenz,de GER,DF,Eint Frankfurt,de Bundesliga,28,1994,0.1,1,1,0,1,0,1,1,100.0,0,0,0,0,0,1,1,0,Matches
1468,Johann Lepenant,fr FRA,MF,Lyon,fr Ligue 1,20,2002,2.8,4,3,2,2,0,1,8,12.5,7,5,0,5,4,8,0,0,Matches
1469,Jefferson Lerma,co COL,"MF,DF",Crystal Palace,eng Premier League,28,1994,26.7,42,25,15,23,4,19,40,47.5,21,31,12,19,36,78,72,0,Matches
1470,Léo Leroy,fr FRA,MF,Montpellier,fr Ligue 1,23,2000,5.5,19,10,8,8,3,6,21,28.6,15,12,3,9,7,26,8,0,Matches
1471,Robert Lewandowski,pl POL,FW,Barcelona,es La Liga,34,1988,30.6,8,5,0,6,2,4,12,33.3,8,13,4,9,9,17,18,0,Matches
1472,Jamie Leweling,de GER,"FW,MF",Stuttgart,de Bundesliga,22,2001,16.9,18,10,4,6,8,5,17,29.4,12,21,1,20,5,23,13,0,Matches
1473,Rico Lewis,eng ENG,"DF,MF",Manchester City,eng Premier League,18,2004,9.0,10,7,4,4,2,3,7,42.9,4,7,1,6,4,14,6,0,Matches
1474,Keane Lewis-Potter,eng ENG,"FW,DF",Brentford,eng Premier League,22,2001,16.0,17,7,5,11,1,7,15,46.7,8,10,2,8,7,24,23,0,Matches
1475,Philipp Lienhart,at AUT,DF,Freiburg,de Bundesliga,27,1996,14.1,20,13,14,5,1,13,23,56.5,10,18,11,7,14,34,51,0,Matches
1476,Matthijs de Ligt,nl NED,DF,Bayern Munich,de Bundesliga,23,1999,15.4,15,12,4,8,3,6,11,54.5,5,14,10,4,19,34,52,0,Matches
1477,Victor Lindelöf,se SWE,DF,Manchester Utd,eng Premier League,29,1994,14.8,15,10,8,7,0,5,13,38.5,8,18,9,9,12,27,40,1,Matches
1478,Jesper Lindstrøm,dk DEN,"FW,MF",Napoli,it Serie A,23,2000,4.8,8,3,2,3,3,4,8,50.0,4,3,0,3,2,10,6,0,Matches
1479,Jesper Lindstrøm,dk DEN,FW,Eint Frankfurt,de Bundesliga,23,2000,0.9,1,1,1,0,0,0,0,,0,0,0,0,0,1,0,0,Matches
1480,Karol Linetty,pl POL,MF,Torino,it Serie A,28,1995,20.6,30,21,9,20,1,9,29,31.0,20,24,8,16,23,53,27,1,Matches
1481,Samuel Lino,br BRA,"DF,MF",Atlético Madrid,es La Liga,23,1999,23.1,61,34,32,17,12,35,70,50.0,35,37,1,36,14,75,27,0,Matches
1482,Luca Lipani,it ITA,MF,Sassuolo,it Serie A,18,2005,4.3,9,7,4,3,2,3,11,27.3,8,9,2,7,6,15,7,0,Matches
1483,Pol Lirola,es ESP,DF,Frosinone,it Serie A,25,1997,17.1,30,18,14,15,1,17,35,48.6,18,12,1,11,19,49,41,1,Matches
1484,Marcin Listkowski,pl POL,FW,Lecce,it Serie A,25,1998,0.1,0,0,0,0,0,0,0,,0,0,0,0,0,0,0,0,Matches
1485,Valentino Livramento,eng ENG,DF,Newcastle Utd,eng Premier League,20,2002,14.6,23,13,15,6,2,10,21,47.6,11,16,7,9,25,48,41,1,Matches
1486,Dejan Ljubicic,at AUT,"MF,FW",Köln,de Bundesliga,25,1997,22.8,43,27,20,18,5,20,43,46.5,23,22,2,20,18,61,11,0,Matches
1487,Javier Llabrés,es ESP,"MF,FW",Mallorca,es La Liga,20,2002,2.7,3,1,1,1,1,1,2,50.0,1,1,0,1,3,6,4,0,Matches
1488,Diego Llorente,es ESP,DF,Roma,it Serie A,29,1993,24.1,31,19,20,10,1,11,24,45.8,13,40,27,13,22,53,79,0,Matches
1489,Marcos Llorente,es ESP,"MF,DF",Atlético Madrid,es La Liga,28,1995,28.5,40,23,18,17,5,16,44,36.4,28,36,11,25,14,54,35,0,Matches
1490,Gautier Lloris,fr FRA,DF,Le Havre,fr Ligue 1,28,1995,30.9,50,28,40,9,1,28,42,66.7,14,50,30,20,32,82,142,1,Matches
1491,Abou Lô,sn SEN,"MF,DF",Metz,fr Ligue 1,23,2000,2.2,3,1,2,1,0,1,4,25.0,3,5,2,3,4,7,8,0,Matches
1492,Giovani Lo Celso,ar ARG,MF,Tottenham,eng Premier League,27,1996,5.6,22,13,10,8,4,9,14,64.3,5,4,1,3,5,27,2,0,Matches
1493,Stanislav Lobotka,sk SVK,MF,Napoli,it Serie A,28,1994,36.5,61,39,18,30,13,24,60,40.0,36,30,8,22,30,91,29,0,Matches
1494,Manuel Locatelli,it ITA,MF,Juventus,it Serie A,25,1998,33.4,69,43,24,35,10,31,58,53.4,27,43,17,26,25,94,65,0,Matches
1495,Bradley Locko,fr FRA,DF,Brest,fr Ligue 1,21,2002,32.9,97,55,57,34,6,47,80,58.8,33,28,1,27,40,137,69,0,Matches
1496,Tom Lockyer,wls WAL,DF,Luton Town,eng Premier League,28,1994,13.0,25,16,17,6,2,15,22,68.2,7,23,13,10,23,48,68,0,Matches
1497,Renan Lodi,br BRA,DF,Marseille,fr Ligue 1,25,1998,13.7,24,16,8,13,3,13,21,61.9,8,7,2,5,16,40,35,0,Matches
1498,Ruben Loftus-Cheek,eng ENG,MF,Milan,it Serie A,27,1996,23.0,28,18,7,14,7,15,27,55.6,12,24,12,12,9,37,10,1,Matches
1499,Elysée Logbo,fr FRA,FW,Le Havre,fr Ligue 1,19,2004,2.8,0,0,0,0,0,0,3,0.0,3,7,3,4,0,0,2,0,Matches
1500,Enzo Loiodice,fr FRA,MF,Las Palmas,es La Liga,22,2000,19.9,62,35,15,34,13,20,42,47.6,22,20,2,18,12,74,16,1,Matches
1501,Sean Longstaff,eng ENG,MF,Newcastle Utd,eng Premier League,25,1997,30.5,54,30,17,29,8,24,63,38.1,39,43,7,36,17,71,23,0,Matches
1502,Ademola Lookman,ng NGA,"FW,MF",Atalanta,it Serie A,25,1997,21.0,20,15,2,11,7,8,22,36.4,14,19,0,19,9,29,0,1,Matches
1503,Noah Loosli,ch SUI,DF,Bochum,de Bundesliga,26,1997,3.8,10,7,6,4,0,7,14,50.0,7,7,1,6,7,17,18,0,Matches
1504,Anthony Lopes,pt POR,GK,Lyon,fr Ligue 1,32,1990,31.0,0,0,0,0,0,0,0,,0,0,0,0,0,0,16,0,Matches
1505,David López,es ESP,DF,Girona,es La Liga,33,1989,21.8,33,20,21,12,0,17,22,77.3,5,28,19,9,20,53,63,4,Matches
1506,Diego López,es ESP,"MF,FW",Valencia,es La Liga,21,2002,29.5,37,25,14,16,7,13,56,23.2,43,23,1,22,20,57,12,0,Matches
1507,Fermin López,es ESP,"MF,FW",Barcelona,es La Liga,20,2003,16.1,41,21,15,18,8,14,40,35.0,26,14,1,13,4,45,9,0,Matches
1508,Javi López,es ESP,DF,Alavés,es La Liga,21,2002,26.5,23,12,11,9,3,15,26,57.7,11,25,9,16,10,33,77,1,Matches
1509,Maxime Lopez,fr FRA,MF,Fiorentina,it Serie A,25,1997,8.9,18,9,5,10,3,6,12,50.0,6,3,1,2,7,25,6,0,Matches
1510,Maxime Lopez,fr FRA,MF,Sassuolo,it Serie A,25,1997,1.6,2,1,1,1,0,1,2,50.0,1,1,1,0,2,4,0,0,Matches
1511,Pau López,es ESP,GK,Marseille,fr Ligue 1,28,1994,32.7,0,0,0,0,0,0,2,0.0,2,0,0,0,0,0,10,1,Matches
1512,Unai López,es ESP,MF,Rayo Vallecano,es La Liga,27,1995,23.4,48,24,18,23,7,21,53,39.6,32,24,3,21,16,64,15,2,Matches
1513,Dion Lopy,sn SEN,MF,Almería,es La Liga,21,2002,21.3,62,37,36,20,6,17,44,38.6,27,23,5,18,15,77,22,2,Matches
1514,Anthony Losilla,fr FRA,MF,Bochum,de Bundesliga,37,1986,28.6,63,37,15,40,8,23,51,45.1,28,37,8,29,25,88,51,0,Matches
1515,Jordan Lotomba,ch SUI,DF,Nice,fr Ligue 1,24,1998,20.0,36,28,18,9,9,25,35,71.4,10,30,9,21,16,52,26,1,Matches
1516,Tom Louchet,fr FRA,"MF,DF",Nice,fr Ligue 1,20,2003,4.5,14,5,6,6,2,7,11,63.6,4,7,3,4,3,17,9,0,Matches
1517,Imran Louza,ma MAR,MF,Lorient,fr Ligue 1,24,1999,9.6,13,7,2,8,3,2,8,25.0,6,8,1,7,9,22,4,0,Matches
1518,Matteo Lovato,it ITA,DF,Torino,it Serie A,23,2000,6.0,10,7,5,5,0,4,5,80.0,1,9,5,4,13,23,10,0,Matches
1519,Matteo Lovato,it ITA,DF,Salernitana,it Serie A,23,2000,10.5,27,14,17,8,2,16,24,66.7,8,14,7,7,18,45,41,1,Matches
1520,Dejan Lovren,hr CRO,DF,Lyon,fr Ligue 1,34,1989,8.0,9,7,6,3,0,3,7,42.9,4,6,5,1,12,21,37,0,Matches
1521,Sandi Lovrić,si SVN,MF,Udinese,it Serie A,25,1998,22.1,25,12,9,11,5,9,23,39.1,14,21,2,19,21,46,24,0,Matches
1522,Max Lowe,eng ENG,"DF,MF",Sheffield Utd,eng Premier League,26,1997,5.6,21,10,13,5,3,8,15,53.3,7,10,4,6,5,26,15,0,Matches
1523,Anthony Lozano,hn HON,"MF,FW",Getafe,es La Liga,30,1993,1.0,0,0,0,0,0,0,1,0.0,1,0,0,0,0,0,1,0,Matches
1524,Anthony Lozano,hn HON,FW,Almería,es La Liga,30,1993,8.6,7,5,2,5,0,4,7,57.1,3,6,1,5,2,9,12,0,Matches
1525,Lucas,br BRA,DF,Cádiz,es La Liga,22,2001,17.1,47,27,32,11,4,32,55,58.2,23,27,4,23,17,64,45,0,Matches
1526,Lorenzo Lucca,it ITA,FW,Udinese,it Serie A,22,2000,28.8,19,11,4,11,4,5,20,25.0,15,18,3,15,3,22,36,1,Matches
1527,Jhon Lucumí,co COL,DF,Bologna,it Serie A,25,1998,24.6,48,29,31,17,0,27,36,75.0,9,32,17,15,16,64,68,2,Matches
1528,José Luis Gayà,es ESP,DF,Valencia,es La Liga,28,1995,19.9,71,36,44,23,4,43,67,64.2,24,18,3,15,11,82,42,0,Matches
1529,José Luis Morales,es ESP,"FW,MF",Villarreal,es La Liga,36,1987,11.6,5,3,1,4,0,3,13,23.1,10,9,1,8,7,12,4,0,Matches
1530,José Luis Palomino,ar ARG,DF,Atalanta,it Serie A,33,1990,0.3,2,1,1,1,0,1,1,100.0,0,2,1,1,1,3,6,0,Matches
1531,Douglas Luiz,br BRA,MF,Aston Villa,eng Premier League,25,1998,33.3,58,38,21,27,10,25,53,47.2,28,32,8,24,23,81,18,2,Matches
1532,Romelu Lukaku,be BEL,FW,Roma,it Serie A,30,1993,29.3,6,5,1,2,3,2,4,50.0,2,7,1,6,0,6,19,1,Matches
1533,Castello Lukeba,fr FRA,DF,RB Leipzig,de Bundesliga,20,2002,24.3,19,12,10,9,0,10,12,83.3,2,35,13,22,12,31,94,2,Matches
1534,Dodi Lukebakio,be BEL,"FW,MF",Sevilla,es La Liga,25,1997,12.5,5,2,2,2,1,1,6,16.7,5,9,2,7,2,7,5,0,Matches
1535,Saša Lukić,rs SRB,MF,Fulham,eng Premier League,26,1996,12.5,33,19,9,17,7,18,39,46.2,21,18,5,13,16,49,19,1,Matches
1536,Karlo Lulić,hr CRO,MF,Frosinone,it Serie A,27,1996,0.2,0,0,0,0,0,0,0,,0,1,0,1,1,1,0,0,Matches
1537,Andriy Lunin,ua UKR,GK,Real Madrid,es La Liga,24,1999,21.0,0,0,0,0,0,0,1,0.0,1,0,0,0,0,0,15,1,Matches
1538,Sebastiano Luperto,it ITA,DF,Empoli,it Serie A,26,1996,37.8,37,26,25,10,2,15,24,62.5,9,46,35,11,32,69,157,1,Matches
1539,Mateus Lusuardi,br BRA,DF,Frosinone,it Serie A,19,2004,2.4,2,1,1,1,0,1,3,33.3,2,4,2,2,4,6,8,0,Matches
1540,Andreas Luthe,de GER,GK,Bochum,de Bundesliga,36,1987,1.0,0,0,0,0,0,0,0,,0,0,0,0,0,0,1,0,Matches
1541,Zito Luvumbo,ao ANG,"FW,MF",Cagliari,it Serie A,21,2002,21.6,9,6,5,2,2,4,15,26.7,11,19,0,19,1,10,2,0,Matches
1542,Charalampos Lykogiannis,gr GRE,DF,Bologna,it Serie A,29,1993,10.0,10,6,5,4,1,5,10,50.0,5,15,5,10,5,15,30,0,Matches
1543,Senne Lynen,be BEL,MF,Werder Bremen,de Bundesliga,24,1999,20.0,64,38,33,27,4,30,70,42.9,40,41,8,33,41,105,56,0,Matches
1544,Joshua M'Bahia,ci CIV,MF,Clermont Foot,fr Ligue 1,18,2005,0.2,0,0,0,0,0,0,0,,0,0,0,0,0,0,0,0,Matches
1545,Othmane Maamma,ma MAR,FW,Montpellier,fr Ligue 1,17,2005,1.0,3,3,2,0,1,1,1,100.0,0,3,0,3,0,3,0,0,Matches
1546,Ian Maatsen,nl NED,"FW,MF",Chelsea,eng Premier League,21,2002,2.3,3,2,1,1,1,0,4,0.0,4,4,0,4,3,6,10,0,Matches
1547,Ian Maatsen,nl NED,DF,Dortmund,de Bundesliga,21,2002,14.0,30,22,15,9,6,16,30,53.3,14,22,4,18,13,43,26,0,Matches
1548,Alexis Mac Allister,ar ARG,MF,Liverpool,eng Premier League,24,1998,28.9,99,55,35,50,14,59,125,47.2,66,65,8,57,35,134,25,1,Matches
1549,Deiver Machado,co COL,DF,Lens,fr Ligue 1,29,1993,12.5,24,18,10,10,4,15,20,75.0,5,13,2,11,7,31,8,0,Matches
1550,Darwin Machís,ve VEN,MF,Cádiz,es La Liga,30,1993,8.7,23,14,7,9,7,13,24,54.2,11,8,1,7,4,27,2,0,Matches
1551,James Maddison,eng ENG,MF,Tottenham,eng Premier League,26,1996,23.7,33,19,5,18,10,15,29,51.7,14,15,3,12,13,46,10,1,Matches
1552,Noni Madueke,eng ENG,FW,Chelsea,eng Premier League,21,2002,11.7,16,10,8,4,4,11,34,32.4,23,11,0,11,4,20,14,0,Matches
1553,Pablo Maffeo,es ESP,DF,Mallorca,es La Liga,26,1997,16.2,35,22,18,13,4,23,40,57.5,17,12,2,10,10,45,23,0,Matches
1554,Gabriel Magalhães,br BRA,DF,Arsenal,eng Premier League,25,1997,33.8,48,28,24,22,2,17,22,77.3,5,44,33,11,31,79,100,1,Matches
1555,Soungoutou Magassa,fr FRA,"DF,MF",Monaco,fr Ligue 1,19,2003,15.0,56,26,22,32,2,26,48,54.2,22,21,4,17,21,77,36,2,Matches
1556,Giulio Maggiore,it ITA,MF,Salernitana,it Serie A,25,1998,20.0,49,29,26,22,1,20,42,47.6,22,27,5,22,24,73,38,0,Matches
1557,Matej Maglica,hr CRO,DF,Darmstadt 98,de Bundesliga,24,1998,18.9,35,21,25,10,0,22,36,61.1,14,29,11,18,22,57,92,5,Matches
1558,Giangiacomo Magnani,it ITA,DF,Hellas Verona,it Serie A,27,1995,27.2,33,18,23,10,0,15,25,60.0,10,50,28,22,45,78,118,0,Matches
1559,Hugo Magnetti,fr FRA,MF,Brest,fr Ligue 1,25,1998,26.0,49,27,18,26,5,24,58,41.4,34,19,1,18,18,67,18,0,Matches
1560,Yohann Magnin,fr FRA,MF,Clermont Foot,fr Ligue 1,26,1997,18.7,49,31,12,32,5,22,47,46.8,25,38,13,25,19,68,26,1,Matches
1561,Frank Magri,cm CMR,"FW,MF",Toulouse,fr Ligue 1,23,1999,16.0,22,14,5,12,5,15,21,71.4,6,16,4,12,4,26,17,0,Matches
1562,Harry Maguire,eng ENG,DF,Manchester Utd,eng Premier League,30,1993,18.4,24,17,14,10,0,12,22,54.5,10,33,24,9,25,49,83,1,Matches
1563,Jon Magunazelaia,es ESP,"FW,MF",Real Sociedad,es La Liga,22,2001,1.3,5,3,2,3,0,4,8,50.0,4,3,0,3,0,5,2,0,Matches
1564,Adel Mahamoud,km COM,FW,Nantes,fr Ligue 1,20,2003,0.1,0,0,0,0,0,0,1,0.0,1,0,0,0,0,0,0,0,Matches
1565,Arne Maier,de GER,MF,Augsburg,de Bundesliga,24,1999,11.1,14,9,5,8,1,5,14,35.7,9,19,2,17,6,20,11,0,Matches
1566,Habib Maïga,ci CIV,"MF,FW",Metz,fr Ligue 1,27,1996,1.6,2,2,1,0,1,1,3,33.3,2,2,0,2,4,6,2,0,Matches
1567,Mike Maignan,fr FRA,GK,Milan,it Serie A,28,1995,29.0,1,0,1,0,0,1,1,100.0,0,1,0,1,1,2,4,3,Matches
1568,Linton Maina,de GER,"FW,MF",Köln,de Bundesliga,24,1999,21.1,18,15,11,5,2,9,28,32.1,19,12,1,11,6,24,12,0,Matches
1569,Patrick Mainka,de GER,DF,Heidenheim,de Bundesliga,28,1994,34.0,85,49,58,24,3,38,74,51.4,36,66,32,34,49,134,158,1,Matches
1570,Kobbie Mainoo,eng ENG,MF,Manchester Utd,eng Premier League,18,2005,21.4,47,27,20,16,11,21,45,46.7,24,20,12,8,22,69,30,1,Matches
1571,Ainsley Maitland-Niles,eng ENG,"DF,MF",Lyon,fr Ligue 1,25,1997,15.9,34,18,12,14,8,19,37,51.4,18,16,6,10,17,51,29,1,Matches
1572,Radosław Majecki,pl POL,GK,Monaco,fr Ligue 1,23,1999,12.0,0,0,0,0,0,0,0,,0,1,0,1,0,0,5,1,Matches
1573,Lovro Majer,hr CRO,MF,Rennes,fr Ligue 1,25,1998,0.2,0,0,0,0,0,0,0,,0,0,0,0,0,0,1,0,Matches
1574,Lovro Majer,hr CRO,"MF,FW",Wolfsburg,de Bundesliga,25,1998,23.4,39,18,17,22,0,12,31,38.7,19,20,1,19,12,51,13,0,Matches
1575,Jean-Victor Makengo,fr FRA,"MF,FW",Lorient,fr Ligue 1,25,1998,5.3,5,4,3,2,0,2,6,33.3,4,12,1,11,8,13,5,0,Matches
1576,Jordy Makengo,fr FRA,DF,Freiburg,de Bundesliga,21,2001,11.4,17,11,11,5,1,6,10,60.0,4,16,4,12,11,28,37,0,Matches
1577,Antoine Makoumbou,cg CGO,MF,Cagliari,it Serie A,25,1998,30.0,41,24,21,15,5,15,30,50.0,15,23,4,19,16,57,27,2,Matches
1578,Nemanja Maksimović,rs SRB,MF,Getafe,es La Liga,28,1995,36.3,65,43,26,31,8,23,41,56.1,18,56,23,33,46,111,61,0,Matches
1579,Julián Malatini,ar ARG,DF,Werder Bremen,de Bundesliga,22,2001,6.7,18,13,12,3,3,16,24,66.7,8,8,1,7,13,31,26,0,Matches
1580,Daniel Maldini,it ITA,"MF,FW",Monza,it Serie A,21,2001,3.7,3,2,0,2,1,3,6,50.0,3,2,0,2,2,5,1,0,Matches
1581,Daniel Maldini,it ITA,"FW,MF",Empoli,it Serie A,21,2001,2.9,4,2,0,2,2,2,2,100.0,0,5,0,5,2,6,2,0,Matches
1582,Youssef Maleh,ma MAR,MF,Empoli,it Serie A,24,1998,28.9,74,48,30,36,8,23,52,44.2,29,62,7,55,25,99,29,0,Matches
1583,Donyell Malen,nl NED,"FW,MF",Dortmund,de Bundesliga,24,1999,19.8,11,7,5,3,3,2,6,33.3,4,11,4,7,2,13,8,0,Matches
1584,Ruslan Malinovskyi,ua UKR,MF,Genoa,it Serie A,30,1993,17.2,35,20,18,11,6,17,41,41.5,24,22,8,14,5,40,16,0,Matches
1585,Lennard Maloney,us USA,MF,Heidenheim,de Bundesliga,23,1999,25.4,43,26,14,24,5,25,59,42.4,34,33,9,24,25,68,88,0,Matches
1586,Aaron Malouda,fr FRA,FW,Lille,fr Ligue 1,17,2005,0.0,0,0,0,0,0,0,0,,0,0,0,0,0,0,0,0,Matches
1587,Giorgi Mamardashvili,ge GEO,GK,Valencia,es La Liga,22,2000,36.5,4,3,4,0,0,4,4,100.0,0,1,0,1,2,6,22,2,Matches
1588,David Mamutovic,de GER,"FW,DF",Mainz 05,de Bundesliga,22,2000,0.1,1,1,0,1,0,1,1,100.0,0,0,0,0,0,1,0,0,Matches
1589,Wilson Manafá,pt POR,"DF,MF",Granada,es La Liga,29,1994,2.7,6,4,3,2,1,4,7,57.1,3,1,0,1,1,7,4,1,Matches
1590,Hianga Mananga Mbock,fr FRA,"MF,FW",Brest,fr Ligue 1,23,1999,0.1,1,0,0,0,1,1,2,50.0,1,0,0,0,1,2,0,0,Matches
1591,Gianluca Mancini,it ITA,DF,Roma,it Serie A,27,1996,31.9,34,20,21,11,2,11,27,40.7,16,38,26,12,36,70,77,1,Matches
1592,Marco Mancosu,it ITA,"MF,FW",Cagliari,it Serie A,34,1988,1.7,3,0,0,2,1,1,2,50.0,1,0,0,0,0,3,0,0,Matches
1593,Steve Mandanda,fr FRA,GK,Rennes,fr Ligue 1,38,1985,34.0,2,0,2,0,0,2,4,50.0,2,0,0,0,0,2,6,1,Matches
1594,Christos Mandas,gr GRE,GK,Lazio,it Serie A,21,2001,8.0,0,0,0,0,0,0,1,0.0,1,0,0,0,1,1,3,1,Matches
1595,Reinildo Mandava,mz MOZ,DF,Atlético Madrid,es La Liga,29,1994,8.1,30,22,16,11,3,19,22,86.4,3,10,2,8,15,45,21,0,Matches
1596,Aïssa Mandi,dz ALG,DF,Villarreal,es La Liga,31,1991,12.4,13,8,8,5,0,7,14,50.0,7,10,7,3,8,21,41,0,Matches
1597,Rolando Mandragora,it ITA,MF,Fiorentina,it Serie A,26,1997,17.6,26,11,8,13,5,10,22,45.5,12,14,3,11,9,35,18,1,Matches
1598,Orel Mangala,be BEL,MF,Nott'ham Forest,eng Premier League,25,1998,17.4,27,13,16,10,1,14,29,48.3,15,12,6,6,26,53,32,0,Matches
1599,Orel Mangala,be BEL,MF,Lyon,fr Ligue 1,25,1998,4.4,5,3,0,2,3,1,3,33.3,2,3,2,1,5,10,6,0,Matches
1600,Vito Mannone,it ITA,GK,Lille,fr Ligue 1,35,1988,1.0,0,0,0,0,0,0,0,,0,0,0,0,0,0,0,0,Matches
1601,Kostas Manolas,gr GRE,DF,Salernitana,it Serie A,32,1991,5.4,9,5,6,3,0,6,8,75.0,2,10,7,3,2,11,20,0,Matches
1602,Javier Manquillo,es ESP,"DF,MF",Celta Vigo,es La Liga,29,1994,8.3,15,11,6,5,4,8,15,53.3,7,14,3,11,3,18,17,0,Matches
1603,Braydon Manu,gh GHA,MF,Darmstadt 98,de Bundesliga,26,1997,1.9,2,0,0,1,1,0,0,,0,1,0,1,0,2,0,0,Matches
1604,Benson Manuel,ao ANG,"MF,FW",Burnley,eng Premier League,26,1997,1.3,3,2,2,1,0,0,0,,0,1,0,1,0,3,0,0,Matches
1605,Faitout Maouassa,fr FRA,"DF,MF",Granada,es La Liga,25,1998,2.5,8,5,6,1,1,4,5,80.0,1,6,0,6,1,9,3,0,Matches
1606,Faitout Maouassa,fr FRA,"MF,DF",Lens,fr Ligue 1,25,1998,0.8,1,1,1,0,0,1,1,100.0,0,1,0,1,0,1,3,0,Matches
1607,Marcão,br BRA,DF,Sevilla,es La Liga,27,1996,3.9,9,6,5,4,0,6,10,60.0,4,8,6,2,4,13,11,1,Matches
1608,Solly March,eng ENG,"FW,DF",Brighton,eng Premier League,29,1994,6.2,19,14,9,7,3,8,14,57.1,6,5,0,5,11,30,8,0,Matches
1609,Riccardo Marchizza,it ITA,DF,Frosinone,it Serie A,25,1998,12.8,7,6,4,3,0,3,13,23.1,10,10,2,8,7,14,33,0,Matches
1610,Gian Marco Ferrari,it ITA,DF,Sassuolo,it Serie A,31,1992,25.2,22,10,11,11,0,12,18,66.7,6,28,17,11,25,47,76,0,Matches
1611,Óscar de Marcos,es ESP,DF,Athletic Club,es La Liga,34,1989,25.1,56,39,26,24,6,42,71,59.2,29,28,6,22,15,71,44,0,Matches
1612,Alberto Marí,es ESP,FW,Valencia,es La Liga,22,2001,3.1,4,2,0,1,3,1,1,100.0,0,3,0,3,0,4,5,0,Matches
1613,José Mari,es ESP,"MF,FW",Cádiz,es La Liga,35,1987,0.2,2,1,0,2,0,1,2,50.0,1,0,0,0,0,2,0,0,Matches
1614,Pablo Marí,es ESP,DF,Monza,it Serie A,29,1993,29.1,41,25,34,7,0,22,34,64.7,12,40,25,15,37,78,115,1,Matches
1615,José María Giménez,uy URU,DF,Atlético Madrid,es La Liga,28,1995,14.7,18,10,10,7,1,5,16,31.3,11,16,12,4,10,28,95,0,Matches
1616,Mariano,do DOM,"FW,MF",Sevilla,es La Liga,29,1993,2.7,1,1,0,1,0,0,1,0.0,1,1,0,1,0,1,2,0,Matches
1617,Mirko Marić,hr CRO,FW,Monza,it Serie A,28,1995,3.2,4,0,2,1,1,0,2,0.0,2,4,0,4,2,6,3,0,Matches
1618,Rafa Marín,es ESP,DF,Alavés,es La Liga,21,2002,27.1,32,20,23,9,0,14,27,51.9,13,34,21,13,33,65,129,2,Matches
1619,Răzvan Marin,ro ROU,MF,Empoli,it Serie A,27,1996,20.2,40,22,13,23,4,19,29,65.5,10,16,4,12,6,46,30,2,Matches
1620,Diego Mariño,es ESP,GK,Almería,es La Liga,33,1990,1.0,0,0,0,0,0,0,0,,0,0,0,0,0,0,1,0,Matches
1621,Guillermo Maripán,cl CHI,DF,Monaco,fr Ligue 1,29,1994,19.6,22,8,15,6,1,10,27,37.0,17,26,13,13,30,52,106,4,Matches
1622,Mika Mármol,es ESP,DF,Las Palmas,es La Liga,22,2001,35.3,70,42,44,24,2,35,53,66.0,18,39,19,20,44,114,147,2,Matches
1623,Omar Marmoush,eg EGY,"FW,MF",Eint Frankfurt,de Bundesliga,24,1999,25.6,21,11,7,8,6,6,16,37.5,10,13,0,13,11,32,7,0,Matches
1624,Marquinhos,br BRA,"FW,MF",Nantes,fr Ligue 1,20,2003,1.7,3,2,2,0,1,1,4,25.0,3,7,2,5,6,9,1,0,Matches
1625,Marquinhos,br BRA,DF,Paris S-G,fr Ligue 1,29,1994,17.1,19,11,10,7,2,11,17,64.7,6,29,19,10,17,36,58,1,Matches
1626,Unai Marrero,es ESP,GK,Real Sociedad,es La Liga,21,2001,1.6,0,0,0,0,0,0,0,,0,0,0,0,0,0,0,0,Matches
1627,Agustín Martegani,ar ARG,MF,Salernitana,it Serie A,23,2000,8.1,13,7,7,3,3,6,18,33.3,12,4,1,3,4,17,7,1,Matches
1628,Eric Martel,de GER,MF,Köln,de Bundesliga,21,2002,27.3,70,43,32,34,4,37,67,55.2,30,65,19,46,43,113,80,0,Matches
1629,Roger Martí,es ESP,FW,Cádiz,es La Liga,32,1991,15.1,12,6,1,9,2,2,7,28.6,5,16,1,15,7,19,4,0,Matches
1630,Anthony Martial,fr FRA,FW,Manchester Utd,eng Premier League,27,1995,5.0,4,1,1,1,2,1,1,100.0,0,4,0,4,0,4,3,0,Matches
1631,Aarón Martín,es ESP,DF,Genoa,it Serie A,26,1997,15.3,21,10,7,10,4,9,22,40.9,13,12,4,8,9,30,15,0,Matches
1632,Iván Martín,es ESP,MF,Girona,es La Liga,24,1999,30.3,44,25,22,15,7,22,57,38.6,35,25,3,22,21,65,14,0,Matches
1633,Jon Martin,es ESP,DF,Real Sociedad,es La Liga,17,2006,0.3,0,0,0,0,0,0,0,,0,0,0,0,0,0,3,0,Matches
1634,Jonas Martin,fr FRA,MF,Brest,fr Ligue 1,33,1990,13.4,43,27,17,24,2,21,36,58.3,15,16,2,14,9,52,28,2,Matches
1635,Mario Martín,es ESP,MF,Real Madrid,es La Liga,19,2004,0.2,5,1,0,2,3,3,4,75.0,1,2,1,1,0,5,0,0,Matches
1636,Gabriel Martinelli,br BRA,FW,Arsenal,eng Premier League,22,2001,22.4,30,24,9,12,9,13,32,40.6,19,23,1,22,5,35,9,1,Matches
1637,Tommaso Martinelli,it ITA,GK,Fiorentina,it Serie A,17,2006,1.0,0,0,0,0,0,0,0,,0,0,0,0,0,0,0,0,Matches
1638,Arnau Martinez,es ESP,DF,Girona,es La Liga,20,2003,13.8,25,16,17,6,2,15,32,46.9,17,15,5,10,10,35,41,3,Matches
1639,Emiliano Martínez,ar ARG,GK,Aston Villa,eng Premier League,30,1992,33.5,0,0,0,0,0,0,0,,0,0,0,0,0,0,12,3,Matches
1640,Iñigo Martínez,es ESP,DF,Barcelona,es La Liga,32,1991,14.4,10,7,9,1,0,6,8,75.0,2,13,10,3,11,21,50,0,Matches
1641,Josep Martinez,es ESP,GK,Genoa,it Serie A,25,1998,36.0,0,0,0,0,0,0,0,,0,0,0,0,1,1,21,3,Matches
1642,Lautaro Martínez,ar ARG,FW,Inter,it Serie A,25,1997,29.5,22,16,4,13,5,4,19,21.1,15,30,1,29,20,42,10,0,Matches
1643,Lisandro Martínez,ar ARG,DF,Manchester Utd,eng Premier League,25,1998,7.2,12,8,8,4,0,5,12,41.7,7,10,8,2,5,17,26,0,Matches
1644,Marc Martínez,es ESP,GK,Granada,es La Liga,33,1990,3.0,0,0,0,0,0,0,1,0.0,1,0,0,0,0,0,1,0,Matches
1645,Lucas Martínez Quarta,ar ARG,DF,Fiorentina,it Serie A,27,1996,25.5,75,47,43,28,4,36,54,66.7,18,38,14,24,30,105,69,4,Matches
1646,Adam Marušić,me MNE,DF,Lazio,it Serie A,30,1992,34.4,45,31,24,19,2,27,49,55.1,22,27,7,20,29,74,63,2,Matches
1647,Marvin,es ESP,"FW,DF",Las Palmas,es La Liga,23,2000,20.6,39,25,18,17,4,18,36,50.0,18,28,2,26,14,53,18,1,Matches
1648,Omar Mascarell,gq EQG,MF,Mallorca,es La Liga,30,1993,17.5,33,16,16,17,0,18,35,51.4,17,24,8,16,31,64,30,1,Matches
1649,Adam Masina,ma MAR,DF,Udinese,it Serie A,29,1994,0.7,4,0,2,2,0,2,4,50.0,2,2,1,1,2,6,5,0,Matches
1650,Adam Masina,ma MAR,DF,Torino,it Serie A,29,1994,11.4,17,12,8,8,1,5,20,25.0,15,12,6,6,11,28,30,0,Matches
1651,Erhan Mašović,rs SRB,"DF,MF",Bochum,de Bundesliga,24,1998,24.7,64,40,37,22,5,37,70,52.9,33,32,10,22,25,89,75,2,Matches
1652,Han-Noah Massengo,fr FRA,"MF,DF",Burnley,eng Premier League,22,2001,0.2,1,1,1,0,0,0,0,,0,1,0,1,0,1,0,0,Matches
1653,Roberto Massimo,de GER,"FW,DF",Stuttgart,de Bundesliga,22,2000,0.9,1,0,1,0,0,1,2,50.0,1,0,0,0,0,1,1,0,Matches
1654,Clinton Mata,ao ANG,DF,Lyon,fr Ligue 1,30,1992,24.7,43,24,29,8,6,23,40,57.5,17,35,16,19,40,83,61,0,Matches
1655,Jaime Mata,es ESP,"FW,MF",Getafe,es La Liga,34,1988,19.9,24,15,12,8,4,11,26,42.3,15,18,1,17,17,41,31,0,Matches
1656,Pape Matar Sarr,sn SEN,MF,Tottenham,eng Premier League,20,2002,23.0,34,24,11,17,6,15,36,41.7,21,21,5,16,31,65,28,1,Matches
1657,Eliot Matazo,be BEL,MF,Monaco,fr Ligue 1,21,2002,1.1,3,1,0,3,0,2,4,50.0,2,1,1,0,3,6,0,0,Matches
1658,Jean-Philippe Mateta,fr FRA,FW,Crystal Palace,eng Premier League,26,1997,25.4,22,15,4,11,7,6,10,60.0,4,13,4,9,4,26,14,0,Matches
1659,Nemanja Matić,rs SRB,MF,Rennes,fr Ligue 1,34,1988,11.4,19,10,7,9,3,9,12,75.0,3,15,7,8,27,46,19,0,Matches
1660,Nemanja Matić,rs SRB,MF,Lyon,fr Ligue 1,34,1988,13.9,17,11,8,7,2,9,19,47.4,10,17,6,11,16,33,17,1,Matches
1661,Joël Matip,cm CMR,DF,Liverpool,eng Premier League,31,1991,8.7,12,6,7,4,1,8,12,66.7,4,16,12,4,9,21,43,0,Matches
1662,Alex Matos,eng ENG,MF,Chelsea,eng Premier League,18,2004,0.0,0,0,0,0,0,0,0,,0,0,0,0,0,0,0,0,Matches
1663,Chrislain Matsima,fr FRA,DF,Clermont Foot,fr Ligue 1,21,2002,13.1,18,11,11,7,0,10,18,55.6,8,14,10,4,13,31,74,1,Matches
1664,Chrislain Matsima,fr FRA,DF,Monaco,fr Ligue 1,21,2002,3.3,9,7,5,3,1,2,7,28.6,5,4,1,3,4,13,4,0,Matches
1665,Jean Mattéo Bahoya,fr FRA,"MF,FW",Eint Frankfurt,de Bundesliga,18,2005,2.0,3,1,0,3,0,1,4,25.0,3,2,0,2,1,4,1,0,Matches
1666,Remi Matthews,eng ENG,GK,Crystal Palace,eng Premier League,29,1994,0.0,0,0,0,0,0,0,0,,0,0,0,0,0,0,1,0,Matches
1667,Alan Matturro,uy URU,DF,Genoa,it Serie A,18,2004,1.2,1,1,1,0,0,1,1,100.0,0,6,3,3,2,3,4,0,Matches
1668,Azor Matusiwa,nl NED,MF,Reims,fr Ligue 1,25,1998,15.4,39,27,17,19,3,22,32,68.8,10,21,3,18,33,72,32,1,Matches
1669,Azor Matusiwa,nl NED,MF,Rennes,fr Ligue 1,25,1998,8.8,7,3,3,4,0,4,7,57.1,3,9,2,7,11,18,17,0,Matches
1670,Neal Maupay,fr FRA,FW,Brentford,eng Premier League,26,1996,14.7,10,7,4,5,1,3,13,23.1,10,11,0,11,2,12,3,0,Matches
1671,Neal Maupay,fr FRA,FW,Everton,eng Premier League,26,1996,1.2,0,0,0,0,0,0,1,0.0,1,2,0,2,0,0,1,0,Matches
1672,Aïman Maurer,ma MAR,"MF,FW",Clermont Foot,fr Ligue 1,18,2004,0.6,1,1,1,0,0,1,3,33.3,2,0,0,0,0,1,0,0,Matches
1673,Konstantinos Mavropanos,gr GRE,DF,West Ham,eng Premier League,25,1997,16.7,28,16,17,9,2,17,21,81.0,4,21,13,8,23,51,79,3,Matches
1674,Christian Mawissa,fr FRA,DF,Toulouse,fr Ligue 1,18,2005,12.4,22,15,14,4,4,9,23,39.1,14,22,11,11,22,44,41,1,Matches
1675,Philipp Max,de GER,DF,Eint Frankfurt,de Bundesliga,29,1993,15.0,26,17,6,18,2,19,26,73.1,7,18,1,17,7,33,18,2,Matches
1676,Eric Maxim Choupo-Moting,cm CMR,"MF,FW",Bayern Munich,de Bundesliga,34,1989,8.0,17,12,8,5,4,6,14,42.9,8,5,0,5,7,24,7,0,Matches
1677,Luís Maximiano,pt POR,GK,Almería,es La Liga,24,1999,33.0,0,0,0,0,0,0,1,0.0,1,0,0,0,0,0,19,2,Matches
1678,Noam Mayoka-Tika,be BEL,MF,Marseille,fr Ligue 1,19,2003,0.0,0,0,0,0,0,0,0,,0,0,0,0,0,0,0,0,Matches
1679,Borja Mayoral,es ESP,FW,Getafe,es La Liga,26,1997,23.9,9,5,2,2,5,5,22,22.7,17,7,0,7,4,13,16,0,Matches
1680,Senny Mayulu,fr FRA,"FW,MF",Paris S-G,fr Ligue 1,17,2006,3.6,13,8,6,6,1,6,7,85.7,1,1,0,1,3,16,0,0,Matches
1681,Youssef Maziz,fr FRA,"FW,MF",Metz,fr Ligue 1,25,1998,1.4,0,0,0,0,0,0,2,0.0,2,1,0,1,1,1,2,0,Matches
1682,Noussair Mazraoui,ma MAR,DF,Bayern Munich,de Bundesliga,25,1997,13.3,32,21,14,11,7,13,21,61.9,8,14,1,13,20,52,27,1,Matches
1683,Luca Mazzitelli,it ITA,MF,Frosinone,it Serie A,27,1995,24.6,45,23,15,24,6,26,49,53.1,23,23,7,16,19,64,62,0,Matches
1684,Pasquale Mazzocchi,it ITA,DF,Salernitana,it Serie A,28,1995,14.1,25,19,14,10,1,16,29,55.2,13,14,6,8,5,30,31,0,Matches
1685,Pasquale Mazzocchi,it ITA,DF,Napoli,it Serie A,28,1995,4.8,5,2,1,2,2,2,3,66.7,1,5,1,4,1,6,13,0,Matches
1686,Kevin Mbabu,ch SUI,DF,Augsburg,de Bundesliga,28,1995,22.7,51,39,25,18,8,23,40,57.5,17,29,9,20,24,75,48,0,Matches
1687,Noah Mbamba,be BEL,MF,Leverkusen,de Bundesliga,18,2005,0.2,0,0,0,0,0,0,0,,0,0,0,0,1,1,0,0,Matches
1688,Ethan Mbappé,fr FRA,"MF,DF",Paris S-G,fr Ligue 1,16,2006,0.5,0,0,0,0,0,0,2,0.0,2,1,0,1,0,0,0,0,Matches
1689,Kylian Mbappé,fr FRA,FW,Paris S-G,fr Ligue 1,24,1998,24.0,4,1,1,1,2,4,9,44.4,5,4,0,4,2,6,2,0,Matches
1690,Malick Mbaye,sn SEN,"MF,FW",Metz,fr Ligue 1,19,2004,1.7,5,1,0,1,4,1,2,50.0,1,1,0,1,1,6,2,0,Matches
1691,Mamadou Mbaye,sn SEN,DF,Cádiz,es La Liga,25,1998,3.2,6,3,3,3,0,2,5,40.0,3,10,7,3,5,11,26,0,Matches
1692,Chancel Mbemba,cd COD,DF,Marseille,fr Ligue 1,28,1994,24.5,33,21,25,7,1,17,30,56.7,13,21,13,8,13,46,95,1,Matches
1693,Nolan Mbemba,cg CGO,MF,Le Havre,fr Ligue 1,28,1995,0.2,2,1,0,1,1,1,2,50.0,1,0,0,0,0,2,0,0,Matches
1694,Bryan Mbeumo,cm CMR,FW,Brentford,eng Premier League,23,1999,21.8,15,10,6,6,3,5,19,26.3,14,26,2,24,7,22,13,0,Matches
1695,Christ Mbondi,fr FRA,FW,Reims,fr Ligue 1,18,2004,0.0,1,1,1,0,0,1,1,100.0,0,0,0,0,0,1,0,0,Matches
1696,Jordi Mboula,es ESP,"FW,MF",Hellas Verona,it Serie A,24,1999,3.4,4,4,1,2,1,4,7,57.1,3,4,1,3,1,5,0,0,Matches
1697,Nathanael Mbuku,cd COD,FW,Augsburg,de Bundesliga,21,2002,0.1,0,0,0,0,0,0,0,,0,1,0,1,0,0,0,0,Matches
1698,James Mcatee,eng ENG,"MF,FW",Sheffield Utd,eng Premier League,20,2002,20.2,32,21,9,13,10,13,33,39.4,20,20,0,20,11,43,18,0,Matches
1699,James Mcatee,eng ENG,MF,Manchester City,eng Premier League,20,2002,0.0,0,0,0,0,0,0,0,,0,1,0,1,0,0,0,0,Matches
1700,Oliver McBurnie,sct SCO,FW,Sheffield Utd,eng Premier League,27,1996,14.2,17,7,4,7,6,5,12,41.7,7,18,2,16,5,22,28,0,Matches
1701,James McConnell,eng ENG,MF,Liverpool,eng Premier League,18,2004,0.0,0,0,0,0,0,0,0,,0,1,0,1,1,1,0,0,Matches
1702,John McGinn,sct SCO,"MF,FW",Aston Villa,eng Premier League,28,1994,33.3,59,35,18,34,7,32,77,41.6,45,33,4,29,21,80,21,0,Matches
1703,Scott McKenna,sct SCO,DF,Nott'ham Forest,eng Premier League,26,1996,4.6,4,0,3,1,0,2,3,66.7,1,6,4,2,5,9,27,0,Matches
1704,Weston McKennie,us USA,"MF,DF",Juventus,it Serie A,24,1998,28.8,48,29,31,11,6,17,27,63.0,10,28,7,21,18,66,69,0,Matches
1705,Dwight McNeil,eng ENG,"MF,FW",Everton,eng Premier League,23,1999,32.1,44,27,16,14,14,24,55,43.6,31,44,7,37,22,66,37,0,Matches
1706,Scott McTominay,sct SCO,"MF,FW",Manchester Utd,eng Premier League,26,1996,21.1,49,25,23,24,2,22,33,66.7,11,34,12,22,14,63,54,0,Matches
1707,Facundo Medina,ar ARG,DF,Lens,fr Ligue 1,24,1999,30.2,64,38,25,31,8,44,69,63.8,25,38,13,25,24,88,59,2,Matches
1708,Ben Mee,eng ENG,DF,Brentford,eng Premier League,33,1989,14.1,26,15,12,12,2,17,22,77.3,5,21,13,8,13,39,63,1,Matches
1709,Marvin Mehlem,de GER,MF,Darmstadt 98,de Bundesliga,25,1997,16.5,28,21,10,14,4,11,27,40.7,16,21,2,19,33,61,15,0,Matches
1710,Bamo Meïté,ci CIV,DF,Marseille,fr Ligue 1,21,2001,7.1,16,10,13,3,0,8,12,66.7,4,11,5,6,11,27,35,0,Matches
1711,Bamo Meïté,ci CIV,DF,Lorient,fr Ligue 1,21,2001,1.6,2,1,2,0,0,0,1,0.0,1,3,2,1,3,5,9,0,Matches
1712,Hannibal Mejbri,tn TUN,"MF,FW",Manchester Utd,eng Premier League,20,2003,1.5,3,3,1,2,0,1,3,33.3,2,1,1,0,0,3,0,0,Matches
1713,Hannibal Mejbri,tn TUN,MF,Sevilla,es La Liga,20,2003,1.2,3,3,1,2,0,0,1,0.0,1,1,0,1,0,3,0,0,Matches
1714,Óscar Melendo,es ESP,"MF,FW",Granada,es La Liga,25,1997,12.5,14,6,4,10,0,4,12,33.3,8,13,0,13,5,19,4,1,Matches
1715,Gonzalo Melero,es ESP,"MF,FW",Almería,es La Liga,29,1994,12.3,14,8,7,5,2,7,19,36.8,12,12,4,8,4,18,11,0,Matches
1716,Birger Meling,no NOR,DF,Rennes,fr Ligue 1,28,1994,0.2,1,1,1,0,0,1,1,100.0,0,1,0,1,0,1,0,0,Matches
1717,Arthur Melo,br BRA,MF,Fiorentina,it Serie A,26,1996,22.1,45,30,17,24,4,26,42,61.9,16,27,3,24,18,63,8,0,Matches
1718,Memphis,nl NED,FW,Atlético Madrid,es La Liga,29,1994,9.9,5,2,0,3,2,3,6,50.0,3,2,0,2,1,6,0,0,Matches
1719,Houboulang Mendes,gw GNB,DF,Almería,es La Liga,25,1998,4.4,16,13,11,5,0,8,16,50.0,8,4,2,2,1,17,17,1,Matches
1720,Nuno Mendes,pt POR,DF,Paris S-G,fr Ligue 1,21,2002,3.0,5,5,4,1,0,4,7,57.1,3,4,0,4,4,9,2,0,Matches
1721,Tomás Mendes,es ESP,MF,Alavés,es La Liga,18,2004,0.1,0,0,0,0,0,0,0,,0,0,0,0,0,0,0,0,Matches
1722,Brais Méndez,es ESP,"MF,FW",Real Sociedad,es La Liga,26,1997,26.8,42,28,13,20,9,15,43,34.9,28,23,4,19,12,54,21,0,Matches
1723,Bruno Méndez,uy URU,DF,Granada,es La Liga,23,1999,14.8,36,17,19,12,5,21,37,56.8,16,24,6,18,26,62,45,0,Matches
1724,Diego Méndez,es ESP,MF,Rayo Vallecano,es La Liga,19,2003,0.1,1,1,1,0,0,1,1,100.0,0,0,0,0,1,2,0,0,Matches
1725,Leonardo Mendicino,it ITA,MF,Atalanta,it Serie A,17,2006,0.0,0,0,0,0,0,0,0,,0,0,0,0,0,0,0,0,Matches
1726,Antoine Mendy,sn SEN,DF,Nice,fr Ligue 1,19,2004,4.6,7,5,4,3,0,3,7,42.9,4,4,1,3,8,15,16,0,Matches
1727,Benjamin Mendy,fr FRA,DF,Lorient,fr Ligue 1,29,1994,7.9,3,1,2,1,0,1,5,20.0,4,8,2,6,7,10,20,0,Matches
1728,Ferland Mendy,fr FRA,DF,Real Madrid,es La Liga,28,1995,19.1,15,10,12,2,1,11,14,78.6,3,12,2,10,13,28,26,1,Matches
1729,Formose Mendy,sn SEN,DF,Lorient,fr Ligue 1,22,2001,14.0,33,19,24,8,1,20,33,60.6,13,23,12,11,20,53,59,1,Matches
1730,Nampalys Mendy,sn SEN,MF,Lens,fr Ligue 1,31,1992,11.7,29,18,10,13,6,16,20,80.0,4,11,4,7,14,43,14,1,Matches
1731,Teden Mengi,eng ENG,DF,Luton Town,eng Premier League,21,2002,27.4,54,22,33,20,1,19,30,63.3,11,39,27,12,57,111,140,1,Matches
1732,Chris Mepham,wls WAL,DF,Bournemouth,eng Premier League,25,1997,6.9,12,11,9,3,0,9,14,64.3,5,13,6,7,7,19,30,1,Matches
1733,Jorge Meré,es ESP,DF,Cádiz,es La Liga,26,1997,7.5,8,7,6,2,0,4,7,57.1,3,5,3,2,8,16,33,0,Matches
1734,Alex Meret,it ITA,GK,Napoli,it Serie A,26,1997,30.8,1,0,1,0,0,1,2,50.0,1,0,0,0,0,1,10,1,Matches
1735,Mikel Merino,es ESP,MF,Real Sociedad,es La Liga,27,1996,27.6,77,43,25,34,18,22,48,45.8,26,36,11,25,16,93,55,3,Matches
1736,Quentin Merlin,fr FRA,DF,Marseille,fr Ligue 1,21,2002,7.8,13,12,7,5,1,8,20,40.0,12,4,0,4,6,19,14,0,Matches
1737,Quentin Merlin,fr FRA,DF,Nantes,fr Ligue 1,21,2002,14.3,29,20,15,12,2,16,25,64.0,9,22,1,21,18,47,22,0,Matches
1738,Junior Messias,br BRA,"MF,DF",Genoa,it Serie A,32,1991,11.7,26,20,19,5,2,8,19,42.1,11,9,1,8,5,31,22,0,Matches
1739,Thomas Meunier,be BEL,DF,Dortmund,de Bundesliga,31,1991,6.5,5,1,3,2,0,3,13,23.1,10,8,2,6,4,9,22,0,Matches
1740,Bastien Meupiyou,fr FRA,DF,Nantes,fr Ligue 1,17,2006,0.1,0,0,0,0,0,0,0,,0,0,0,0,0,0,1,0,Matches
1741,Alexander Meyer,de GER,GK,Dortmund,de Bundesliga,32,1991,7.7,1,1,1,0,0,1,1,100.0,0,0,0,0,0,1,2,1,Matches
1742,Omenuke Mfulu,cd COD,"MF,FW",Las Palmas,es La Liga,29,1994,0.9,4,3,3,1,0,0,1,0.0,1,1,1,0,2,6,5,0,Matches
1743,Lucas Michal,fr FRA,FW,Monaco,fr Ligue 1,18,2005,0.1,0,0,0,0,0,0,0,,0,0,0,0,0,0,0,0,Matches
1744,Sven Michel,de GER,"FW,MF",Augsburg,de Bundesliga,33,1990,6.5,7,5,2,1,4,2,7,28.6,5,1,0,1,0,7,4,0,Matches
1745,Miguel,es ESP,"FW,MF",Alavés,es La Liga,23,1999,0.7,0,0,0,0,0,0,0,,0,2,0,2,0,0,0,0,Matches
1746,Georges Mikautadze,ge GEO,FW,Metz,fr Ligue 1,22,2000,19.4,4,3,1,2,1,0,9,0.0,9,11,0,11,8,12,3,0,Matches
1747,Nikola Milenković,rs SRB,DF,Fiorentina,it Serie A,25,1997,27.9,41,21,24,14,3,22,36,61.1,14,22,14,8,27,68,95,1,Matches
1748,Lewis Miley,eng ENG,MF,Newcastle Utd,eng Premier League,17,2006,13.4,33,21,6,20,7,15,32,46.9,17,20,3,17,8,41,18,2,Matches
1749,Arkadiusz Milik,pl POL,FW,Juventus,it Serie A,29,1994,10.2,9,5,2,5,2,3,5,60.0,2,7,1,6,5,14,3,0,Matches
1750,Vanja Milinković-Savić,rs SRB,GK,Torino,it Serie A,26,1997,36.0,1,0,1,0,0,1,1,100.0,0,0,0,0,1,2,14,4,Matches
1751,Éder Militão,br BRA,DF,Real Madrid,es La Liga,25,1998,5.5,7,3,4,3,0,6,9,66.7,3,4,3,1,4,11,19,1,Matches
1752,Luis Milla,es ESP,MF,Getafe,es La Liga,28,1994,23.5,57,33,19,28,10,28,47,59.6,19,20,1,19,32,89,10,0,Matches
1753,Enzo Millot,fr FRA,"MF,FW",Stuttgart,de Bundesliga,21,2002,24.9,40,22,9,21,10,18,39,46.2,21,24,2,22,16,56,7,1,Matches
1754,James Milner,eng ENG,"DF,MF",Brighton,eng Premier League,37,1986,8.6,20,14,9,10,1,9,14,64.3,5,9,0,9,8,28,16,0,Matches
1755,Jovan Milošević,rs SRB,"FW,MF",Stuttgart,de Bundesliga,18,2005,0.3,0,0,0,0,0,0,0,,0,0,0,0,0,0,0,0,Matches
1756,Marko Milovanović,rs SRB,"FW,MF",Almería,es La Liga,19,2003,3.4,4,4,1,3,0,2,4,50.0,2,2,0,2,0,4,5,0,Matches
1757,Kim Min-jae,kr KOR,DF,Bayern Munich,de Bundesliga,26,1996,21.9,37,24,21,11,5,12,24,50.0,12,29,19,10,45,82,70,2,Matches
1758,Yerry Mina,co COL,"DF,MF",Fiorentina,it Serie A,28,1994,0.5,1,1,1,0,0,1,2,50.0,1,0,0,0,0,1,2,0,Matches
1759,Yerry Mina,co COL,DF,Cagliari,it Serie A,28,1994,13.5,20,13,14,6,0,13,19,68.4,6,23,14,9,4,24,77,0,Matches
1760,Takumi Minamino,jp JPN,MF,Monaco,fr Ligue 1,28,1995,23.5,34,17,10,13,11,16,54,29.6,38,29,1,28,11,45,8,0,Matches
1761,Lucas Mincarelli,fr FRA,"DF,MF",Montpellier,fr Ligue 1,19,2004,10.9,29,16,19,6,4,17,34,50.0,17,17,4,13,8,37,27,0,Matches
1762,Tyrone Mings,eng ENG,DF,Aston Villa,eng Premier League,30,1993,0.3,0,0,0,0,0,0,0,,0,0,0,0,1,1,1,0,Matches
1763,Óscar Mingueza,es ESP,"DF,MF",Celta Vigo,es La Liga,24,1999,33.3,62,38,44,11,7,37,80,46.3,43,38,7,31,17,79,49,2,Matches
1764,Ignasi Miquel,es ESP,DF,Granada,es La Liga,30,1992,33.2,47,30,39,6,2,23,40,57.5,17,32,16,16,45,92,132,4,Matches
1765,Rafa Mir,es ESP,"FW,MF",Sevilla,es La Liga,26,1997,4.3,2,2,1,1,0,1,2,50.0,1,2,0,2,1,3,1,0,Matches
1766,Ignacio Miramon,ar ARG,MF,Lille,fr Ligue 1,20,2003,0.4,1,0,0,1,0,0,1,0.0,1,1,0,1,0,1,0,0,Matches
1767,Aleksei Miranchuk,ru RUS,"MF,FW",Atalanta,it Serie A,27,1995,13.1,12,6,6,4,2,5,13,38.5,8,6,1,5,2,14,5,1,Matches
1768,Juan Miranda,es ESP,DF,Betis,es La Liga,23,2000,20.6,38,24,21,13,4,17,31,54.8,14,31,6,25,19,57,62,0,Matches
1769,Kevin Miranda,it ITA,DF,Sassuolo,it Serie A,20,2003,0.2,0,0,0,0,0,0,0,,0,0,0,0,0,0,1,0,Matches
1770,Antonio Mirante,it ITA,GK,Milan,it Serie A,40,1983,2.0,0,0,0,0,0,0,0,,0,0,0,0,0,0,1,0,Matches
1771,Fabio Miretti,it ITA,MF,Juventus,it Serie A,19,2003,12.3,18,14,6,8,4,10,26,38.5,16,10,1,9,7,25,6,0,Matches
1772,Filippo Missori,it ITA,DF,Sassuolo,it Serie A,19,2004,3.0,6,3,2,4,0,4,11,36.4,7,3,2,1,4,10,8,0,Matches
1773,Tyrick Mitchell,eng ENG,"DF,MF",Crystal Palace,eng Premier League,23,1999,35.6,105,60,75,21,9,43,60,71.7,17,63,10,53,26,131,104,0,Matches
1774,Kaoru Mitoma,jp JPN,FW,Brighton,eng Premier League,26,1997,16.5,13,6,3,7,3,5,19,26.3,14,15,1,14,5,18,12,0,Matches
1775,Aleksandar Mitrović,rs SRB,FW,Fulham,eng Premier League,28,1994,0.4,0,0,0,0,0,0,0,,0,0,0,0,0,0,0,0,Matches
1776,Stefan Mitrović,rs SRB,"FW,MF",Hellas Verona,it Serie A,20,2002,4.3,6,3,0,5,1,2,5,40.0,3,6,1,5,0,6,4,0,Matches
1777,Stefan Mitrović,rs SRB,DF,Getafe,es La Liga,33,1990,7.8,9,3,7,2,0,4,8,50.0,4,3,2,1,6,15,26,0,Matches
1778,Maximilian Mittelstädt,de GER,DF,Stuttgart,de Bundesliga,26,1997,23.4,91,51,46,39,6,53,89,59.6,36,36,6,30,46,137,65,0,Matches
1779,Henrikh Mkhitaryan,am ARM,MF,Inter,it Serie A,34,1989,30.9,62,34,18,35,9,24,49,49.0,25,23,4,19,29,91,43,0,Matches
1780,Marko Mladenović,rs SRB,MF,Eint Frankfurt,de Bundesliga,18,2005,0.1,0,0,0,0,0,0,0,,0,0,0,0,0,0,0,0,Matches
1781,Jakub Moder,pl POL,"MF,DF",Brighton,eng Premier League,24,1999,6.9,19,10,9,5,5,9,18,50.0,9,8,2,6,2,21,12,0,Matches
1782,Luka Modrić,hr CRO,MF,Real Madrid,es La Liga,37,1985,18.8,22,15,10,6,6,9,25,36.0,16,13,4,9,21,43,9,0,Matches
1783,Max Moerstedt,de GER,"DF,FW",Hoffenheim,de Bundesliga,,,0.1,0,0,0,0,0,0,1,0.0,1,0,0,0,0,0,0,0,Matches
1784,Terem Moffi,ng NGA,FW,Nice,fr Ligue 1,24,1999,21.7,7,4,0,5,2,3,12,25.0,9,14,1,13,3,10,15,0,Matches
1785,Mostafa Mohamed,eg EGY,FW,Nantes,fr Ligue 1,25,1997,22.2,21,14,7,11,3,6,28,21.4,22,21,5,16,12,33,29,0,Matches
1786,Johan Mojica,co COL,DF,Osasuna,es La Liga,30,1992,22.7,30,22,11,15,4,16,25,64.0,9,15,2,13,21,51,40,2,Matches
1787,Alberto Moleiro,es ESP,"FW,MF",Las Palmas,es La Liga,19,2003,20.0,15,6,4,7,4,6,30,20.0,24,11,0,11,7,22,10,0,Matches
1788,Nahuel Molina,ar ARG,DF,Atlético Madrid,es La Liga,25,1998,20.6,38,22,16,18,4,26,54,48.1,28,19,3,16,9,47,36,1,Matches
1789,Florent Mollet,fr FRA,"MF,FW",Nantes,fr Ligue 1,31,1991,23.1,18,11,8,6,4,10,31,32.3,21,18,5,13,13,31,17,0,Matches
1790,Jon Moncayola,es ESP,MF,Osasuna,es La Liga,25,1998,20.0,27,18,14,10,3,17,42,40.5,25,31,5,26,15,42,21,0,Matches
1791,Enzo Mongo,fr FRA,DF,Nantes,fr Ligue 1,18,2005,0.1,1,1,1,0,0,1,2,50.0,1,1,1,0,1,2,0,0,Matches
1792,Ilario Monterisi,it ITA,DF,Frosinone,it Serie A,21,2001,16.3,23,13,14,7,2,12,26,46.2,14,22,18,4,8,31,63,0,Matches
1793,César Montes,mx MEX,DF,Almería,es La Liga,26,1997,19.9,22,13,13,9,0,9,18,50.0,9,21,9,12,11,33,94,0,Matches
1794,Gonzalo Montiel,ar ARG,DF,Nott'ham Forest,eng Premier League,26,1997,8.9,22,19,12,8,2,16,29,55.2,13,8,3,5,9,31,31,1,Matches
1795,Lorenzo Montipò,it ITA,GK,Hellas Verona,it Serie A,27,1996,37.0,1,1,1,0,0,1,3,33.3,2,0,0,0,0,1,25,2,Matches
1796,Kieffer Moore,wls WAL,"FW,MF",Bournemouth,eng Premier League,30,1992,1.2,0,0,0,0,0,0,0,,0,0,0,0,0,0,0,0,Matches
1797,Mikey Moore,eng ENG,MF,Tottenham,eng Premier League,15,2007,0.0,0,0,0,0,0,0,0,,0,0,0,0,0,0,1,0,Matches
1798,Álvaro Morata,es ESP,FW,Atlético Madrid,es La Liga,30,1992,21.2,16,10,4,7,5,3,5,60.0,2,18,3,15,1,17,26,0,Matches
1799,Diego Moreira,be BEL,"FW,MF",Lyon,fr Ligue 1,18,2004,3.0,0,0,0,0,0,0,3,0.0,3,3,0,3,2,2,5,0,Matches
1800,Alberto Moreno,es ESP,DF,Villarreal,es La Liga,31,1992,16.5,31,21,19,10,2,10,30,33.3,20,12,2,10,24,55,33,0,Matches
1801,Álex Moreno,es ESP,DF,Aston Villa,eng Premier League,30,1993,11.5,18,12,18,0,0,12,19,63.2,7,11,2,9,13,31,37,0,Matches
1802,Gerard Moreno,es ESP,FW,Villarreal,es La Liga,31,1992,24.6,25,12,10,7,8,11,25,44.0,14,24,7,17,9,34,24,0,Matches
1803,Jorge Moreno,es ESP,DF,Osasuna,es La Liga,22,2001,0.2,0,0,0,0,0,0,0,,0,1,0,1,0,0,3,0,Matches
1804,Mateu Morey,es ESP,DF,Dortmund,de Bundesliga,23,2000,1.2,2,2,1,1,0,2,4,50.0,2,3,1,2,1,3,3,0,Matches
1805,Ilaix Moriba,gn GUI,"MF,FW",Getafe,es La Liga,20,2003,6.7,20,11,3,11,6,4,9,44.4,5,3,1,2,4,24,10,0,Matches
1806,Manu Morlanes,es ESP,MF,Mallorca,es La Liga,24,1999,17.9,50,29,23,26,1,23,53,43.4,30,13,1,12,20,70,21,0,Matches
1807,Nikola Moro,hr CRO,MF,Bologna,it Serie A,25,1998,9.3,21,16,8,12,1,8,15,53.3,7,14,1,13,7,28,10,0,Matches
1808,Carlton Morris,eng ENG,"FW,MF",Luton Town,eng Premier League,27,1995,31.8,15,8,4,6,5,9,15,60.0,6,24,5,19,1,16,53,0,Matches
1809,Cristhian Mosquera,es ESP,DF,Valencia,es La Liga,19,2004,34.2,57,34,36,18,3,25,39,64.1,14,42,23,19,36,93,137,2,Matches
1810,Yerson Mosquera,co COL,DF,Villarreal,es La Liga,22,2001,13.7,27,13,18,7,2,12,15,80.0,3,12,2,10,17,44,65,0,Matches
1811,Dany Mota,pt POR,"FW,MF",Monza,it Serie A,25,1998,22.8,13,7,2,5,6,8,17,47.1,9,4,1,3,2,15,18,0,Matches
1812,Lebo Mothiba,za RSA,FW,Strasbourg,fr Ligue 1,27,1996,6.9,5,2,1,4,0,3,4,75.0,1,6,1,5,0,5,11,0,Matches
1813,Youssoufa Moukoko,de GER,FW,Dortmund,de Bundesliga,18,2004,6.9,4,1,2,2,0,3,7,42.9,4,4,1,3,2,6,4,0,Matches
1814,Steve Mounié,bj BEN,FW,Brest,fr Ligue 1,28,1994,19.7,8,7,0,3,5,3,11,27.3,8,13,3,10,2,10,18,0,Matches
1815,Mason Mount,eng ENG,"MF,FW",Manchester Utd,eng Premier League,24,1999,5.7,22,14,6,10,6,6,16,37.5,10,6,1,5,6,28,3,0,Matches
1816,Samuel Moutoussamy,cd COD,MF,Nantes,fr Ligue 1,26,1996,12.3,38,20,14,17,7,17,37,45.9,20,16,3,13,11,49,13,0,Matches
1817,Loris Mouyokolo,fr FRA,DF,Lorient,fr Ligue 1,22,2001,1.0,4,1,4,0,0,1,1,100.0,0,1,0,1,0,4,3,0,Matches
1818,Divin Mubama,eng ENG,FW,West Ham,eng Premier League,18,2004,0.9,0,0,0,0,0,0,0,,0,0,0,0,0,0,0,0,Matches
1819,Mykhailo Mudryk,ua UKR,FW,Chelsea,eng Premier League,22,2001,17.5,21,12,9,7,5,10,32,31.3,22,14,1,13,9,30,9,0,Matches
1820,François Mughe,cm CMR,"MF,DF",Marseille,fr Ligue 1,19,2004,2.0,0,0,0,0,0,0,3,0.0,3,2,0,2,1,1,1,0,Matches
1821,Nordi Mukiele,fr FRA,DF,Paris S-G,fr Ligue 1,25,1997,8.8,12,8,6,5,1,8,15,53.3,7,17,4,13,14,26,28,0,Matches
1822,Samuele Mulattieri,it ITA,"FW,MF",Sassuolo,it Serie A,22,2000,5.1,1,1,0,0,1,1,2,50.0,1,7,2,5,1,2,2,0,Matches
1823,Andreas Müller,de GER,MF,Darmstadt 98,de Bundesliga,23,2000,3.9,14,9,8,5,1,4,9,44.4,5,5,2,3,4,18,5,0,Matches
1824,Jannik Müller,de GER,"DF,MF",Darmstadt 98,de Bundesliga,29,1994,12.6,33,16,21,9,3,16,27,59.3,11,24,12,12,17,50,39,1,Matches
1825,Kevin Müller,de GER,GK,Heidenheim,de Bundesliga,32,1991,34.0,3,0,3,0,0,3,5,60.0,2,0,0,0,0,3,6,1,Matches
1826,Marcus Müller,de GER,MF,Mainz 05,de Bundesliga,20,2002,0.2,0,0,0,0,0,0,0,,0,0,0,0,0,0,0,0,Matches
1827,Thomas Müller,de GER,"MF,FW",Bayern Munich,de Bundesliga,33,1989,18.4,26,16,5,10,11,13,35,37.1,22,22,0,22,3,29,6,0,Matches
1828,Abdul Mumin,gh GHA,DF,Rayo Vallecano,es La Liga,25,1998,18.8,19,10,13,4,2,8,10,80.0,2,27,19,8,22,41,82,1,Matches
1829,Marshall Munetsi,zw ZIM,MF,Reims,fr Ligue 1,27,1996,24.1,61,39,18,34,9,33,61,54.1,28,21,7,14,14,75,33,0,Matches
1830,Iker Muniain,es ESP,"MF,FW",Athletic Club,es La Liga,30,1992,6.6,5,1,2,3,0,1,3,33.3,2,4,1,3,0,5,0,0,Matches
1831,Rodrigo Muniz,br BRA,FW,Fulham,eng Premier League,22,2001,17.7,7,3,1,5,1,1,6,16.7,5,9,3,6,6,13,20,0,Matches
1832,Aihen Muñoz,es ESP,DF,Real Sociedad,es La Liga,25,1997,12.5,36,21,20,10,6,24,35,68.6,11,16,8,8,9,45,33,0,Matches
1833,Daniel Muñoz,co COL,"DF,MF",Crystal Palace,eng Premier League,27,1996,16.0,55,35,31,14,10,19,38,50.0,19,29,7,22,24,79,47,0,Matches
1834,Iker Muñoz,es ESP,MF,Osasuna,es La Liga,20,2002,20.6,32,18,13,17,2,15,31,48.4,16,16,5,11,11,43,50,0,Matches
1835,Javier Muñoz,es ESP,MF,Las Palmas,es La Liga,28,1995,29.3,42,23,14,22,6,16,44,36.4,28,40,4,36,20,62,29,1,Matches
1836,Finley Munroe,eng ENG,MF,Aston Villa,eng Premier League,18,2005,0.0,0,0,0,0,0,0,0,,0,0,0,0,0,0,0,0,Matches
1837,Arijanet Muric,xk KVX,GK,Burnley,eng Premier League,24,1998,10.0,1,1,1,0,0,1,1,100.0,0,0,0,0,0,1,10,4,Matches
1838,Luis Muriel,co COL,"FW,MF",Atalanta,it Serie A,32,1991,4.5,3,2,0,2,1,1,1,100.0,0,4,0,4,1,4,0,0,Matches
1839,Murillo,br BRA,DF,Nott'ham Forest,eng Premier League,21,2002,31.0,50,31,36,13,1,19,33,57.6,14,41,24,17,37,87,188,0,Matches
1840,Vedat Muriqi,xk KVX,FW,Mallorca,es La Liga,29,1994,25.9,11,6,4,3,4,2,14,14.3,12,11,4,7,6,17,26,0,Matches
1841,Alex Murphy,ie IRL,"DF,FW",Newcastle Utd,eng Premier League,19,2004,0.1,1,1,0,1,0,1,2,50.0,1,1,0,1,1,2,0,0,Matches
1842,Jacob Murphy,eng ENG,"FW,DF",Newcastle Utd,eng Premier League,28,1995,13.2,20,10,8,4,8,12,26,46.2,14,17,0,17,6,26,16,0,Matches
1843,Yunus Musah,us USA,"MF,FW",Milan,it Serie A,20,2002,16.4,25,14,15,6,4,8,15,53.3,7,18,4,14,10,35,16,1,Matches
1844,Jamal Musiala,de GER,"MF,FW",Bayern Munich,de Bundesliga,20,2003,19.5,40,25,9,21,10,14,36,38.9,22,25,1,24,16,56,5,0,Matches
1845,Florent Muslija,xk KVX,"MF,FW",Freiburg,de Bundesliga,25,1998,1.2,5,4,3,2,0,2,5,40.0,3,1,0,1,0,5,2,0,Matches
1846,Juan Musso,ar ARG,GK,Atalanta,it Serie A,29,1994,11.0,1,0,1,0,0,1,1,100.0,0,0,0,0,0,1,6,0,Matches
1847,Kingstone Mutandwa,zm ZAM,"FW,MF",Cagliari,it Serie A,20,2003,0.4,1,0,1,0,0,1,4,25.0,3,1,0,1,0,1,2,0,Matches
1848,Yvon Mvogo,ch SUI,GK,Lorient,fr Ligue 1,29,1994,34.0,0,0,0,0,0,0,1,0.0,1,0,0,0,0,0,15,3,Matches
1849,Joel Mvuka,no NOR,"DF,FW",Lorient,fr Ligue 1,20,2002,2.2,5,3,3,1,1,3,7,42.9,4,1,0,1,2,7,1,0,Matches
1850,Junior Mwanga,fr FRA,"MF,FW",Strasbourg,fr Ligue 1,20,2003,16.1,40,20,23,12,5,12,24,50.0,12,20,5,15,18,58,19,0,Matches
1851,Phillipp Mwene,at AUT,DF,Mainz 05,de Bundesliga,29,1994,22.2,34,15,15,16,3,16,33,48.5,17,27,3,24,17,51,47,0,Matches
1852,Vitaliy Mykolenko,ua UKR,DF,Everton,eng Premier League,24,1999,27.4,69,38,46,21,2,41,66,62.1,25,36,11,25,36,105,92,0,Matches
1853,Joakim Mæhle,dk DEN,"DF,MF",Wolfsburg,de Bundesliga,26,1997,27.2,62,39,33,18,11,41,64,64.1,23,43,5,38,29,91,65,0,Matches
1854,Obite N'Dicka,ci CIV,DF,Roma,it Serie A,23,1999,24.1,32,18,12,19,1,12,20,60.0,8,30,16,14,16,48,75,0,Matches
1855,Kévin N'Doram,fr FRA,MF,Metz,fr Ligue 1,27,1996,17.8,31,22,20,9,2,17,38,44.7,21,17,8,9,27,58,38,0,Matches
1856,Nathan N'Goumou,cm CMR,"FW,MF",Gladbach,de Bundesliga,23,2000,15.4,37,22,17,18,2,16,34,47.1,18,22,0,22,5,42,17,1,Matches
1857,Stanley N'Soki,fr FRA,DF,Hoffenheim,de Bundesliga,24,1999,7.0,21,10,12,8,1,17,29,58.6,12,13,2,11,8,29,33,0,Matches
1858,Nacho,es ESP,DF,Real Madrid,es La Liga,33,1990,19.4,18,10,9,7,2,6,13,46.2,7,23,13,10,18,36,56,0,Matches
1859,Bilal Nadir,ma MAR,"MF,FW",Marseille,fr Ligue 1,19,2003,1.3,4,3,2,2,0,1,2,50.0,1,0,0,0,2,6,2,0,Matches
1860,Mahamadou Nagida,cm CMR,DF,Rennes,fr Ligue 1,18,2005,1.2,1,1,0,0,1,0,2,0.0,2,2,1,1,4,5,0,0,Matches
1861,Marvelous Nakamba,zw ZIM,MF,Luton Town,eng Premier League,29,1994,12.6,40,24,24,14,2,24,42,57.1,18,23,6,17,11,51,11,1,Matches
1862,Keito Nakamura,jp JPN,"FW,MF",Reims,fr Ligue 1,23,2000,15.3,28,11,9,10,9,17,37,45.9,20,15,2,13,6,34,7,0,Matches
1863,Nahitan Nández,uy URU,"MF,DF",Cagliari,it Serie A,27,1995,26.0,59,40,27,23,9,27,64,42.2,37,25,2,23,19,78,32,0,Matches
1864,Matija Nastasić,rs SRB,DF,Mallorca,es La Liga,30,1993,25.1,35,17,26,9,0,24,32,75.0,8,33,20,13,29,64,114,0,Matches
1865,Natan,br BRA,DF,Napoli,it Serie A,22,2001,10.6,14,10,10,3,1,5,10,50.0,5,12,9,3,8,22,32,0,Matches
1866,Lapo Nava,it ITA,GK,Milan,it Serie A,19,2004,0.0,0,0,0,0,0,0,0,,0,0,0,0,0,0,0,0,Matches
1867,Roberto Navarro,es ESP,"MF,FW",Cádiz,es La Liga,21,2002,21.0,46,29,20,21,5,22,43,51.2,21,33,0,33,19,65,7,1,Matches
1868,Jesús Navas,es ESP,DF,Sevilla,es La Liga,37,1985,22.3,37,27,21,14,2,22,40,55.0,18,15,7,8,22,59,48,0,Matches
1869,Keylor Navas,cr CRC,GK,Paris S-G,fr Ligue 1,36,1986,4.0,0,0,0,0,0,0,0,,0,0,0,0,0,0,2,0,Matches
1870,Michel Ndary Adopo,fr FRA,MF,Atalanta,it Serie A,23,2000,1.2,4,3,0,3,1,1,1,100.0,0,0,0,0,0,4,2,1,Matches
1871,Youssouf Ndayishimiye,bi BDI,"MF,DF",Nice,fr Ligue 1,24,1998,19.0,31,20,17,12,2,12,23,52.2,11,19,11,8,12,43,47,1,Matches
1872,Bassirou Ndiaye,sn SEN,FW,Lorient,fr Ligue 1,21,2002,1.7,5,2,2,2,1,3,5,60.0,2,1,1,0,1,6,0,0,Matches
1873,Iliman Ndiaye,sn SEN,"FW,MF",Marseille,fr Ligue 1,23,2000,18.0,21,18,5,11,5,11,29,37.9,18,14,2,12,6,27,6,0,Matches
1874,Massamba Ndiaye,sn SEN,GK,Clermont Foot,fr Ligue 1,21,2001,4.0,0,0,0,0,0,0,0,,0,0,0,0,0,0,2,0,Matches
1875,Rassoul Ndiaye,sn SEN,"MF,FW",Le Havre,fr Ligue 1,21,2001,5.8,25,17,8,16,1,12,24,50.0,12,2,1,1,4,29,5,0,Matches
1876,Michael Ndiweni,eng ENG,FW,Newcastle Utd,eng Premier League,19,2003,0.0,0,0,0,0,0,0,0,,0,0,0,0,0,0,0,0,Matches
1877,Cher Ndour,it ITA,MF,Paris S-G,fr Ligue 1,19,2004,0.3,2,2,0,2,0,1,2,50.0,1,0,0,0,0,2,0,0,Matches
1878,Dan Ndoye,ch SUI,"FW,MF",Bologna,it Serie A,22,2000,19.7,30,15,17,11,2,17,39,43.6,22,20,1,19,10,40,14,0,Matches
1879,Joseph Nduquidi,fr FRA,"MF,DF",Metz,fr Ligue 1,18,2004,8.3,11,4,6,3,2,1,9,11.1,8,11,3,8,11,22,15,1,Matches
1880,Loïc Nego,hu HUN,"DF,MF",Le Havre,fr Ligue 1,32,1991,17.3,37,26,21,12,4,18,30,60.0,12,12,2,10,16,53,17,0,Matches
1881,Álvaro Negredo,es ESP,"FW,MF",Cádiz,es La Liga,37,1985,0.6,0,0,0,0,0,0,0,,0,1,0,1,1,1,0,0,Matches
1882,Reiss Nelson,eng ENG,FW,Arsenal,eng Premier League,23,1999,3.0,9,6,5,1,3,8,10,80.0,2,5,1,4,1,10,5,0,Matches
1883,Zack Nelson,eng ENG,"MF,DF",Luton Town,eng Premier League,18,2004,0.1,1,0,1,0,0,0,0,,0,0,0,0,0,1,0,0,Matches
1884,Neto,br BRA,GK,Bournemouth,eng Premier League,34,1989,32.0,0,0,0,0,0,0,0,,0,1,0,1,1,1,12,3,Matches
1885,Pedro Neto,pt POR,"FW,MF",Wolves,eng Premier League,23,2000,16.8,7,3,3,2,2,5,15,33.3,10,5,1,4,5,12,2,0,Matches
1886,Luca Netz,de GER,DF,Gladbach,de Bundesliga,20,2003,24.7,38,22,19,16,3,23,43,53.5,20,36,10,26,22,60,76,1,Matches
1887,Manuel Neuer,de GER,GK,Bayern Munich,de Bundesliga,37,1986,22.8,1,1,1,0,0,0,0,,0,0,0,0,0,1,14,3,Matches
1888,Florian Neuhaus,de GER,MF,Gladbach,de Bundesliga,26,1997,13.6,15,12,7,8,0,8,26,30.8,18,8,6,2,14,29,8,0,Matches
1889,Carlos Neva,es ESP,DF,Granada,es La Liga,27,1996,35.0,32,21,22,9,1,17,40,42.5,23,39,14,25,30,62,108,2,Matches
1890,Jessic Ngankam,de GER,"FW,MF",Mainz 05,de Bundesliga,23,2000,2.0,1,1,0,1,0,0,0,,0,3,1,2,3,4,0,0,Matches
1891,Jessic Ngankam,de GER,FW,Eint Frankfurt,de Bundesliga,23,2000,3.1,3,2,1,1,1,0,0,,0,0,0,0,0,3,1,0,Matches
1892,Cyril Ngonge,be BEL,"FW,MF",Hellas Verona,it Serie A,23,2000,15.9,14,9,5,3,6,5,14,35.7,9,7,1,6,4,18,10,0,Matches
1893,Cyril Ngonge,be BEL,FW,Napoli,it Serie A,23,2000,3.5,5,3,1,4,0,2,2,100.0,0,2,0,2,0,5,2,0,Matches
1894,Steve Ngoura,fr FRA,"FW,MF",Le Havre,fr Ligue 1,18,2005,2.5,2,1,1,1,0,1,4,25.0,3,0,0,0,0,2,3,0,Matches
1895,Moussa Niakhate,sn SEN,DF,Nott'ham Forest,eng Premier League,27,1996,16.2,42,25,33,9,0,20,25,80.0,5,19,12,7,14,56,51,0,Matches
1896,M'Baye Niang,sn SEN,FW,Empoli,it Serie A,28,1994,7.9,3,1,0,1,2,0,6,0.0,6,7,1,6,3,6,10,0,Matches
1897,Tanguy Nianzou,fr FRA,DF,Sevilla,es La Liga,21,2002,3.5,12,8,9,2,1,8,11,72.7,3,2,0,2,3,15,9,1,Matches
1898,Shamar Nicholson,jm JAM,FW,Clermont Foot,fr Ligue 1,26,1997,16.5,6,2,0,4,2,1,4,25.0,3,6,2,4,0,6,15,0,Matches
1899,Rasmus Nicolaisen,dk DEN,DF,Toulouse,fr Ligue 1,26,1997,32.5,50,30,39,11,0,26,44,59.1,18,44,33,11,42,92,158,1,Matches
1900,Moritz Nicolas,de GER,GK,Gladbach,de Bundesliga,25,1997,27.0,1,0,1,0,0,1,3,33.3,2,0,0,0,0,1,12,5,Matches
1901,Hans Nicolussi Caviglia,it ITA,MF,Juventus,it Serie A,23,2000,3.0,5,2,1,3,1,4,6,66.7,2,5,1,4,0,5,2,0,Matches
1902,Saúl Ñíguez,es ESP,MF,Atlético Madrid,es La Liga,28,1994,15.3,64,39,29,29,6,30,49,61.2,19,36,9,27,14,78,56,0,Matches
1903,Justin Njinmah,de GER,FW,Werder Bremen,de Bundesliga,22,2000,11.3,5,1,2,2,1,3,9,33.3,6,9,1,8,2,7,6,0,Matches
1904,Eddie Nketiah,eng ENG,FW,Arsenal,eng Premier League,24,1999,12.0,12,7,2,6,4,2,7,28.6,5,11,0,11,4,16,4,0,Matches
1905,Niels Nkounkou,fr FRA,"DF,MF",Eint Frankfurt,de Bundesliga,22,2000,14.5,54,30,34,17,3,29,64,45.3,35,30,2,28,16,70,30,0,Matches
1906,Christopher Nkunku,fr FRA,"FW,MF",Chelsea,eng Premier League,25,1997,4.9,5,4,0,4,1,1,2,50.0,1,4,1,3,2,7,4,0,Matches
1907,Felix Nmecha,de GER,MF,Dortmund,de Bundesliga,22,2000,11.3,19,13,7,8,4,11,22,50.0,11,18,5,13,11,30,19,0,Matches
1908,Lukas Nmecha,de GER,FW,Wolfsburg,de Bundesliga,24,1998,0.5,1,1,0,0,1,0,0,,0,1,0,1,0,1,0,0,Matches
1909,Peru Nolaskoain,es ESP,"DF,MF",Athletic Club,es La Liga,24,1998,0.1,1,1,1,0,0,1,1,100.0,0,0,0,0,0,1,1,0,Matches
1910,Joseph Nonge,be BEL,MF,Juventus,it Serie A,18,2005,0.3,0,0,0,0,0,0,0,,0,0,0,0,0,0,1,0,Matches
1911,Jonathan Norbye,no NOR,MF,RB Leipzig,de Bundesliga,16,2007,0.0,0,0,0,0,0,0,0,,0,0,0,0,0,0,0,0,Matches
1912,Arnaud Nordin,fr FRA,"FW,MF",Montpellier,fr Ligue 1,25,1998,13.8,12,6,3,5,4,6,16,37.5,10,11,0,11,2,14,10,0,Matches
1913,Rhys Norrington-Davies,wls WAL,DF,Sheffield Utd,eng Premier League,24,1999,1.2,1,1,1,0,0,0,1,0.0,1,2,0,2,1,2,2,0,Matches
1914,Oliver Norwood,nir NIR,MF,Sheffield Utd,eng Premier League,32,1991,16.0,41,26,18,18,5,20,47,42.6,27,24,9,15,21,62,39,0,Matches
1915,Tijjani Noslin,nl NED,"FW,MF",Hellas Verona,it Serie A,24,1999,14.9,18,8,5,7,6,6,16,37.5,10,17,2,15,2,20,14,0,Matches
1916,Randy Nteka,ao ANG,"FW,MF",Rayo Vallecano,es La Liga,25,1997,6.4,11,4,1,6,4,4,10,40.0,6,6,1,5,2,13,11,1,Matches
1917,Ernest Nuamah,gh GHA,"FW,MF",Lyon,fr Ligue 1,19,2003,20.4,28,14,18,6,4,12,38,31.6,26,15,1,14,8,36,9,0,Matches
1918,Alexander Nübel,de GER,GK,Stuttgart,de Bundesliga,26,1996,30.0,2,2,2,0,0,2,4,50.0,2,0,0,0,0,2,13,4,Matches
1919,Kasim Nuhu,gh GHA,DF,Hoffenheim,de Bundesliga,28,1995,0.1,0,0,0,0,0,0,0,,0,0,0,0,0,0,0,0,Matches
1920,Matheus Nunes,pt POR,MF,Wolves,eng Premier League,24,1998,2.0,3,1,3,0,0,2,6,33.3,4,0,0,0,6,9,1,0,Matches
1921,Matheus Nunes,pt POR,MF,Manchester City,eng Premier League,24,1998,7.3,10,4,1,7,2,5,16,31.3,11,7,1,6,1,11,8,1,Matches
1922,Darwin Núñez,uy URU,FW,Liverpool,eng Premier League,24,1999,22.7,22,12,2,10,10,11,23,47.8,12,18,6,12,3,25,9,0,Matches
1923,Unai Núñez,es ESP,DF,Celta Vigo,es La Liga,26,1997,31.1,51,28,30,19,2,23,49,46.9,26,38,24,14,52,103,153,3,Matches
1924,Fabian Nürnberger,bg BUL,"DF,MF",Darmstadt 98,de Bundesliga,24,1999,16.8,29,22,22,6,1,22,41,53.7,19,11,1,10,17,46,26,0,Matches
1925,Ethan Nwaneri,eng ENG,FW,Arsenal,eng Premier League,16,2007,0.2,0,0,0,0,0,0,0,,0,1,0,1,0,0,0,0,Matches
1926,Simeon Nwankwo,ng NGA,FW,Salernitana,it Serie A,31,1992,7.6,6,3,0,2,4,1,3,33.3,2,7,0,7,0,6,4,0,Matches
1927,Gerzino Nyamsi,fr FRA,DF,Strasbourg,fr Ligue 1,26,1997,12.1,18,14,13,5,0,12,18,66.7,6,19,11,8,10,28,43,0,Matches
1928,Ørjan Nyland,no NOR,GK,Sevilla,es La Liga,32,1990,24.0,0,0,0,0,0,0,1,0.0,1,0,0,0,0,0,9,1,Matches
1929,Rabby Nzingoula,fr FRA,"MF,FW",Strasbourg,fr Ligue 1,17,2005,1.5,3,3,0,3,0,3,4,75.0,1,4,0,4,5,8,0,0,Matches
1930,M'Bala Nzola,ao ANG,FW,Fiorentina,it Serie A,26,1996,17.2,11,8,1,4,6,6,7,85.7,1,10,1,9,0,11,22,0,Matches
1931,Christian Nørgaard,dk DEN,MF,Brentford,eng Premier League,29,1994,27.8,81,50,42,31,8,32,87,36.8,55,48,6,42,54,135,50,0,Matches
1932,Jake O'Brien,ie IRL,DF,Lyon,fr Ligue 1,22,2001,26.3,22,16,16,5,1,14,20,70.0,6,23,18,5,12,34,98,1,Matches
1933,Mark O'Mahony,ie IRL,FW,Brighton,eng Premier League,18,2005,0.7,1,0,1,0,0,1,2,50.0,1,2,1,1,0,1,1,0,Matches
1934,Dara O'Shea,ie IRL,DF,Burnley,eng Premier League,24,1999,32.1,39,20,22,14,3,11,26,42.3,15,41,30,11,35,74,158,2,Matches
1935,Michael Obafemi,ie IRL,"FW,MF",Burnley,eng Premier League,23,2000,0.2,0,0,0,0,0,0,0,,0,1,0,1,0,0,0,0,Matches
1936,Adam Obert,sk SVK,DF,Cagliari,it Serie A,20,2002,10.5,17,9,8,8,1,8,17,47.1,9,13,7,6,21,38,41,1,Matches
1937,Pedro Obiang,gq EQG,MF,Sassuolo,it Serie A,31,1992,5.0,8,4,3,4,1,2,10,20.0,8,6,4,2,8,16,10,0,Matches
1938,Jan Oblak,si SVN,GK,Atlético Madrid,es La Liga,30,1993,38.0,0,0,0,0,0,0,0,,0,0,0,0,0,0,10,0,Matches
1939,Brian Ocampo,uy URU,"MF,FW",Cádiz,es La Liga,24,1999,2.8,4,3,1,3,0,2,5,40.0,3,4,0,4,3,7,0,0,Matches
1940,Lucas Ocampos,ar ARG,"FW,MF",Sevilla,es La Liga,29,1994,31.9,66,47,22,27,17,29,58,50.0,29,34,1,33,21,87,29,0,Matches
1941,Guillermo Ochoa,mx MEX,GK,Salernitana,it Serie A,38,1985,21.0,0,0,0,0,0,0,1,0.0,1,0,0,0,0,0,9,1,Matches
1942,Jens Odgaard,dk DEN,"FW,MF",Bologna,it Serie A,24,1999,4.8,4,4,1,1,2,1,3,33.3,2,9,0,9,1,5,3,0,Matches
1943,Wilson Odobert,fr FRA,"MF,FW",Burnley,eng Premier League,18,2004,23.3,17,13,8,5,4,6,22,27.3,16,26,2,24,6,23,14,0,Matches
1944,Álvaro Odriozola,es ESP,DF,Real Sociedad,es La Liga,27,1995,4.4,9,7,7,1,1,5,5,100.0,0,2,1,1,8,17,7,0,Matches
1945,Tim Oermann,de GER,DF,Bochum,de Bundesliga,19,2003,7.9,19,11,11,4,4,9,14,64.3,5,15,6,9,2,21,22,0,Matches
1946,Odeluga Offiah,eng ENG,DF,Brighton,eng Premier League,20,2002,1.4,1,0,1,0,0,1,1,100.0,0,0,0,0,1,2,0,0,Matches
1947,Chiedozie Ogbene,ie IRL,"MF,DF",Luton Town,eng Premier League,26,1997,22.2,17,10,10,7,0,12,22,54.5,10,14,3,11,7,24,34,2,Matches
1948,Angelo Ogbonna,it ITA,DF,West Ham,eng Premier League,35,1988,7.1,11,5,9,2,0,6,7,85.7,1,13,10,3,3,14,29,0,Matches
1949,Florent Ogier,fr FRA,DF,Clermont Foot,fr Ligue 1,34,1989,10.5,19,9,13,6,0,11,18,61.1,7,25,19,6,9,28,35,3,Matches
1950,Noah Okafor,ch SUI,"FW,MF",Milan,it Serie A,23,2000,9.9,6,4,1,4,1,3,10,30.0,7,8,1,7,0,6,10,0,Matches
1951,David Okereke,ng NGA,"FW,MF",Torino,it Serie A,25,1997,2.8,3,1,1,1,1,0,3,0.0,3,2,0,2,1,4,0,0,Matches
1952,Caleb Okoli,it ITA,DF,Frosinone,it Serie A,22,2001,32.4,56,34,33,22,1,29,44,65.9,15,48,32,16,29,85,156,4,Matches
1953,Maduka Okoye,ng NGA,GK,Udinese,it Serie A,23,1999,21.0,0,0,0,0,0,0,0,,0,0,0,0,1,1,4,2,Matches
1954,Masaya Okugawa,jp JPN,"FW,DF",Augsburg,de Bundesliga,27,1996,0.4,0,0,0,0,0,0,0,,0,0,0,0,0,0,2,0,Matches
1955,Joseph Okumu,ke KEN,DF,Reims,fr Ligue 1,26,1997,19.4,44,28,28,14,2,24,38,63.2,14,27,19,8,35,79,112,2,Matches
1956,Aingeru Olabarrieta,es ESP,FW,Athletic Club,es La Liga,17,2005,0.1,0,0,0,0,0,0,0,,0,0,0,0,0,0,0,0,Matches
1957,Michael Olakigbe,eng ENG,"DF,FW",Brentford,eng Premier League,19,2004,0.7,3,0,2,1,0,2,4,50.0,2,7,0,7,1,4,0,1,Matches
1958,Olasagasti,es ESP,MF,Real Sociedad,es La Liga,22,2000,4.0,16,13,4,7,5,5,8,62.5,3,2,0,2,3,19,5,1,Matches
1959,Finn Ole Becker,de GER,MF,Hoffenheim,de Bundesliga,23,2000,6.7,10,9,8,2,0,4,17,23.5,13,9,1,8,1,11,10,0,Matches
1960,Mathias Olesen,lu LUX,"MF,FW",Köln,de Bundesliga,22,2001,1.2,0,0,0,0,0,0,0,,0,0,0,0,2,2,2,0,Matches
1961,Michael Olise,fr FRA,"FW,MF",Crystal Palace,eng Premier League,21,2001,14.2,19,10,7,10,2,8,24,33.3,16,21,0,21,11,30,9,0,Matches
1962,Mathías Olivera,uy URU,DF,Napoli,it Serie A,25,1997,17.4,50,29,29,15,6,23,39,59.0,16,35,6,29,20,70,25,0,Matches
1963,Dani Olmo,es ESP,MF,RB Leipzig,de Bundesliga,25,1998,16.1,26,18,14,8,4,10,22,45.5,12,7,0,7,13,39,12,1,Matches
1964,Robin Olsen,se SWE,GK,Aston Villa,eng Premier League,33,1990,4.5,0,0,0,0,0,0,0,,0,0,0,0,0,0,1,0,Matches
1965,Warmed Omari,km COM,DF,Rennes,fr Ligue 1,23,2000,23.0,32,19,23,7,2,16,28,57.1,12,30,20,10,33,65,77,2,Matches
1966,Becir Omeragic,ch SUI,"DF,MF",Montpellier,fr Ligue 1,21,2002,25.7,48,29,31,13,4,20,33,60.6,13,51,29,22,27,75,65,0,Matches
1967,Jonas Omlin,ch SUI,GK,Gladbach,de Bundesliga,29,1994,7.0,1,0,1,0,0,1,1,100.0,0,0,0,0,0,1,3,0,Matches
1968,Andrew Omobamidele,ie IRL,DF,Nott'ham Forest,eng Premier League,21,2002,8.7,10,3,9,1,0,5,8,62.5,3,12,8,4,13,23,42,1,Matches
1969,Samu Omorodion,es ESP,FW,Alavés,es La Liga,19,2004,21.3,6,3,1,4,1,0,4,0.0,4,11,2,9,1,7,14,0,Matches
1970,Samu Omorodion,es ESP,FW,Granada,es La Liga,19,2004,0.9,1,1,0,1,0,1,1,100.0,0,0,0,0,0,1,0,0,Matches
1971,Amadou Onana,be BEL,MF,Everton,eng Premier League,21,2001,23.2,71,38,32,31,8,21,42,50.0,21,25,6,19,21,92,31,0,Matches
1972,André Onana,cm CMR,GK,Manchester Utd,eng Premier League,27,1996,38.0,2,0,2,0,0,2,2,100.0,0,0,0,0,0,2,11,2,Matches
1973,Jean Onana,cm CMR,MF,Marseille,fr Ligue 1,23,2000,6.3,23,14,6,14,3,13,25,52.0,12,10,2,8,11,34,11,1,Matches
1974,Ryan One,sct SCO,FW,Sheffield Utd,eng Premier League,17,2006,0.1,0,0,0,0,0,0,0,,0,0,0,0,0,0,0,0,Matches
1975,Karim Onisiwo,at AUT,"FW,MF",Mainz 05,de Bundesliga,31,1992,16.6,17,8,4,6,7,6,11,54.5,5,18,4,14,2,19,7,0,Matches
1976,Tyler Onyango,eng ENG,MF,Everton,eng Premier League,20,2003,0.0,0,0,0,0,0,0,0,,0,0,0,0,0,0,0,0,Matches
1977,Fred Onyedinma,eng ENG,"DF,MF",Luton Town,eng Premier League,26,1996,4.5,10,6,7,3,0,5,12,41.7,7,3,0,3,1,11,13,0,Matches
1978,Frank Onyeka,ng NGA,MF,Brentford,eng Premier League,25,1998,12.9,37,24,9,23,5,16,29,55.2,13,15,7,8,23,60,17,0,Matches
1979,Loïs Openda,be BEL,FW,RB Leipzig,de Bundesliga,23,2000,30.0,3,3,0,1,2,0,6,0.0,6,19,3,16,5,8,14,0,Matches
1980,Royce Openda Owaga,ga GAB,FW,Lorient,fr Ligue 1,21,2002,0.2,0,0,0,0,0,0,0,,0,0,0,0,0,0,0,0,Matches
1981,Christopher Operi,ci CIV,DF,Le Havre,fr Ligue 1,26,1997,27.2,55,36,37,15,3,32,59,54.2,27,45,7,38,35,90,68,1,Matches
1982,Leon Opitz,de GER,"FW,DF",Werder Bremen,de Bundesliga,18,2005,0.2,2,2,1,1,0,2,3,66.7,1,0,0,0,0,2,0,0,Matches
1983,Gift Orban,ng NGA,FW,Lyon,fr Ligue 1,21,2002,5.3,4,3,0,1,3,1,4,25.0,3,2,0,2,1,5,2,1,Matches
1984,Willi Orban,hu HUN,DF,RB Leipzig,de Bundesliga,30,1992,17.6,20,12,8,10,2,9,18,50.0,9,22,13,9,16,36,76,1,Matches
1985,Ivan Ordets,ua UKR,DF,Bochum,de Bundesliga,31,1992,20.9,19,14,11,6,2,10,17,58.8,7,41,29,12,31,50,130,0,Matches
1986,Divock Origi,be BEL,FW,Nott'ham Forest,eng Premier League,28,1995,6.7,6,4,5,0,1,0,0,,0,6,0,6,2,8,4,0,Matches
1987,Gaetano Oristanio,it ITA,"FW,MF",Cagliari,it Serie A,20,2002,12.3,20,10,5,14,1,5,17,29.4,12,11,0,11,9,29,8,0,Matches
1988,Aimar Oroz,es ESP,MF,Osasuna,es La Liga,21,2001,26.0,43,26,18,20,5,13,37,35.1,24,27,2,25,16,59,11,0,Matches
1989,Riccardo Orsolini,it ITA,"FW,MF",Bologna,it Serie A,26,1997,19.9,23,14,13,4,6,9,30,30.0,21,25,3,22,8,31,19,1,Matches
1990,Stefan Ortega,de GER,GK,Manchester City,eng Premier League,30,1992,7.1,0,0,0,0,0,0,0,,0,0,0,0,0,0,2,1,Matches
1991,Eneko Ortiz,es ESP,DF,Alavés,es La Liga,20,2003,0.2,0,0,0,0,0,0,0,,0,0,0,0,0,0,0,0,Matches
1992,Asier Osambela,es ESP,MF,Osasuna,es La Liga,19,2004,0.1,2,1,0,1,1,0,0,,0,0,0,0,0,2,0,0,Matches
1993,Ben Osborn,eng ENG,"DF,MF",Sheffield Utd,eng Premier League,28,1994,15.2,22,9,11,9,2,8,17,47.1,9,18,2,16,8,30,30,0,Matches
1994,Gabriel Osho,ng NGA,DF,Luton Town,eng Premier League,24,1998,20.5,41,22,21,19,1,16,27,59.3,11,37,20,17,31,72,92,0,Matches
1995,Victor Osimhen,ng NGA,FW,Napoli,it Serie A,24,1998,22.0,9,5,0,4,5,2,4,50.0,2,5,1,4,2,11,18,0,Matches
1996,Milutin Osmajić,me MNE,MF,Cádiz,es La Liga,24,1999,0.1,0,0,0,0,0,0,0,,0,0,0,0,0,0,0,0,Matches
1997,Patrick Osterhage,de GER,MF,Bochum,de Bundesliga,23,2000,20.7,38,26,14,23,1,17,36,47.2,19,36,9,27,27,65,32,1,Matches
1998,William Osula,dk DEN,FW,Sheffield Utd,eng Premier League,19,2003,8.7,2,2,1,0,1,1,2,50.0,1,3,1,2,2,4,9,0,Matches
1999,Dango Ouattara,bf BFA,"FW,DF",Bournemouth,eng Premier League,21,2002,13.7,45,27,22,11,12,19,34,55.9,15,18,3,15,22,67,35,0,Matches
2000,Kassoum Ouattara,fr FRA,"DF,FW",Monaco,fr Ligue 1,18,2004,7.1,17,12,8,5,4,9,20,45.0,11,11,0,11,13,30,20,0,Matches
2001,Remi Oudin,fr FRA,"MF,FW",Lecce,it Serie A,26,1996,20.2,26,14,12,12,2,12,19,63.2,7,13,1,12,20,46,22,0,Matches
2002,Alexandre Oukidja,dz ALG,GK,Metz,fr Ligue 1,35,1988,33.2,2,1,2,0,0,1,2,50.0,1,1,0,1,3,5,24,3,Matches
2003,Azzedine Ounahi,ma MAR,MF,Marseille,fr Ligue 1,23,2000,13.4,25,11,9,14,2,11,32,34.4,21,6,1,5,11,36,8,0,Matches
2004,Adam Ounas,dz ALG,FW,Lille,fr Ligue 1,26,1996,4.6,4,3,2,2,0,2,7,28.6,5,2,0,2,6,10,1,0,Matches
2005,Patrick Ouotro,ci CIV,FW,Strasbourg,fr Ligue 1,17,2005,0.1,0,0,0,0,0,0,0,,0,0,0,0,0,0,0,0,Matches
2006,Aiham Ousou,sy SYR,DF,Cádiz,es La Liga,23,2000,4.8,8,5,6,2,0,5,5,100.0,0,1,0,1,7,15,15,0,Matches
2007,Jesús Owono,gq EQG,GK,Alavés,es La Liga,22,2001,4.0,0,0,0,0,0,0,0,,0,0,0,0,0,0,3,0,Matches
2008,Mikel Oyarzabal,es ESP,"FW,MF",Real Sociedad,es La Liga,26,1997,24.0,23,18,7,11,5,7,21,33.3,14,25,4,21,4,27,12,0,Matches
2009,Anthony Oyono,ga GAB,DF,Frosinone,it Serie A,22,2001,13.3,37,26,21,14,2,23,34,67.6,11,17,3,14,9,46,32,0,Matches
2010,Salih Özcan,tr TUR,MF,Dortmund,de Bundesliga,25,1998,13.2,20,12,11,8,1,10,18,55.6,8,28,3,25,17,37,18,1,Matches
2011,Cenk Özkacar,tr TUR,DF,Valencia,es La Liga,22,2000,17.8,26,15,22,4,0,15,23,65.2,8,18,7,11,18,44,84,1,Matches
2012,David Ozoh,eng ENG,"MF,DF",Crystal Palace,eng Premier League,18,2005,1.7,10,6,3,6,1,5,6,83.3,1,2,0,2,0,10,2,0,Matches
2013,Jon Pacheco,es ESP,DF,Real Sociedad,es La Liga,22,2001,17.0,25,15,21,4,0,14,22,63.6,8,17,6,11,10,35,53,1,Matches
2014,Willian Pacho,ec ECU,DF,Eint Frankfurt,de Bundesliga,21,2001,33.0,62,37,38,23,1,31,53,58.5,22,51,22,29,47,109,152,2,Matches
2015,Gonçalo Paciência,pt POR,"FW,MF",Bochum,de Bundesliga,28,1994,7.2,8,4,2,2,4,3,6,50.0,3,5,0,5,0,8,7,0,Matches
2016,Simone Pafundi,it ITA,MF,Udinese,it Serie A,17,2006,0.1,0,0,0,0,0,0,0,,0,0,0,0,0,0,0,0,Matches
2017,Riccardo Pagano,it ITA,"MF,DF",Roma,it Serie A,18,2004,0.6,2,2,1,1,0,0,6,0.0,6,3,2,1,0,2,2,0,Matches
2018,Pablo Pagis,fr FRA,MF,Lorient,fr Ligue 1,20,2002,1.8,10,6,5,4,1,6,10,60.0,4,2,0,2,3,13,1,0,Matches
2019,Exequiel Palacios,ar ARG,MF,Leverkusen,de Bundesliga,24,1998,20.3,60,34,28,26,6,26,53,49.1,27,24,0,24,29,89,20,2,Matches
2020,Isaac Palazón Camacho,es ESP,"MF,FW",Rayo Vallecano,es La Liga,28,1994,31.0,46,25,16,21,9,20,58,34.5,38,29,2,27,16,62,41,0,Matches
2021,João Palhinha,pt POR,MF,Fulham,eng Premier League,28,1995,30.0,152,75,80,60,12,103,152,67.8,49,57,9,48,46,198,58,0,Matches
2022,Nicolas Pallois,fr FRA,DF,Nantes,fr Ligue 1,35,1987,17.7,34,19,21,11,2,19,35,54.3,16,37,26,11,26,60,111,0,Matches
2023,Cole Palmer,eng ENG,MF,Manchester City,eng Premier League,21,2002,0.1,0,0,0,0,0,0,0,,0,0,0,0,0,0,0,0,Matches
2024,Cole Palmer,eng ENG,"FW,MF",Chelsea,eng Premier League,21,2002,29.0,23,12,9,6,8,8,19,42.1,11,20,2,18,20,43,13,2,Matches
2025,Emerson Palmieri,it ITA,DF,West Ham,eng Premier League,28,1994,34.9,106,68,48,42,16,57,90,63.3,33,47,15,32,43,149,96,0,Matches
2026,Joaquín Panichelli,ar ARG,"FW,MF",Alavés,es La Liga,20,2002,2.5,3,3,1,1,1,1,2,50.0,1,1,0,1,1,4,4,0,Matches
2027,Miloš Pantović,rs SRB,MF,Union Berlin,de Bundesliga,27,1996,0.2,0,0,0,0,0,0,0,,0,0,0,0,0,0,0,0,Matches
2028,Antonios Papadopoulos,de GER,DF,Dortmund,de Bundesliga,23,1999,1.3,6,3,6,0,0,6,7,85.7,1,3,2,1,2,8,7,0,Matches
2029,Christos Papadopoulos,gr GRE,FW,Genoa,it Serie A,18,2004,0.0,0,0,0,0,0,0,1,0.0,1,0,0,0,0,0,0,0,Matches
2030,Sokratis Papastathopoulos,gr GRE,DF,Betis,es La Liga,35,1988,12.6,21,14,16,5,0,13,17,76.5,4,15,9,6,6,27,60,0,Matches
2031,Merveille Papela,de GER,"MF,DF",Mainz 05,de Bundesliga,22,2001,2.9,5,4,2,3,0,0,4,0.0,4,1,0,1,4,9,2,0,Matches
2032,Leart Paqarada,xk KVX,DF,Köln,de Bundesliga,28,1994,11.9,21,11,9,9,3,11,22,50.0,11,17,5,12,10,31,30,1,Matches
2033,Lucas Paquetá,br BRA,"FW,MF",West Ham,eng Premier League,25,1997,29.1,71,48,38,26,7,25,52,48.1,27,28,1,27,21,92,28,2,Matches
2034,Victor Parada,es ESP,"FW,MF",Alavés,es La Liga,21,2002,0.0,1,1,0,1,0,1,1,100.0,0,0,0,0,0,1,0,0,Matches
2035,Aitor Paredes,es ESP,DF,Athletic Club,es La Liga,23,2000,30.0,20,11,11,9,0,7,14,50.0,7,23,11,12,33,53,104,0,Matches
2036,Kevin Paredes,us USA,"FW,MF",Wolfsburg,de Bundesliga,20,2003,15.9,42,21,22,13,7,20,34,58.8,14,27,2,25,23,65,26,0,Matches
2037,Leandro Paredes,ar ARG,MF,Roma,it Serie A,29,1994,29.3,57,36,30,22,5,33,77,42.9,44,26,7,19,29,86,43,1,Matches
2038,Daniel Parejo,es ESP,MF,Villarreal,es La Liga,34,1989,28.7,43,30,16,21,6,20,46,43.5,26,25,9,16,21,64,29,3,Matches
2039,Fabiano Parisi,it ITA,DF,Fiorentina,it Serie A,22,2000,16.2,30,15,11,12,7,15,26,57.7,11,21,5,16,17,47,26,0,Matches
2040,Ben Parkinson,eng ENG,FW,Newcastle Utd,eng Premier League,18,2005,0.3,0,0,0,0,0,0,0,,0,1,0,1,0,0,1,0,Matches
2041,Thomas Partey,gh GHA,"MF,DF",Arsenal,eng Premier League,30,1993,8.8,14,11,9,4,1,5,10,50.0,5,9,3,6,11,25,9,0,Matches
2042,Mario Pašalić,hr CRO,MF,Atalanta,it Serie A,28,1995,22.8,28,17,9,18,1,14,31,45.2,17,29,6,23,16,44,34,0,Matches
2043,Triantafyllos Pasaridīs,gr GRE,DF,Salernitana,it Serie A,27,1996,5.0,11,7,9,2,0,9,14,64.3,5,7,3,4,3,14,19,0,Matches
2044,Pascu,es ESP,FW,Villarreal,es La Liga,20,2003,0.2,0,0,0,0,0,0,0,,0,0,0,0,0,0,0,0,Matches
2045,Felix Passlack,de GER,DF,Bochum,de Bundesliga,25,1998,10.7,21,14,9,10,2,14,24,58.3,10,13,2,11,10,31,21,0,Matches
2046,Patric,es ESP,DF,Lazio,it Serie A,30,1993,17.9,13,8,10,3,0,8,18,44.4,10,15,9,6,6,19,44,0,Matches
2047,Rui Patrício,pt POR,GK,Roma,it Serie A,35,1988,23.0,0,0,0,0,0,0,1,0.0,1,1,0,1,0,0,3,1,Matches
2048,Nathan Patterson,sct SCO,DF,Everton,eng Premier League,21,2001,11.2,34,24,21,11,2,14,37,37.8,23,14,3,11,9,43,33,0,Matches
2049,Gabriel Paulista,br BRA,DF,Atlético Madrid,es La Liga,32,1990,4.5,7,5,4,3,0,3,4,75.0,1,5,3,2,4,11,27,0,Matches
2050,Gabriel Paulista,br BRA,DF,Valencia,es La Liga,32,1990,15.5,10,7,8,2,0,6,11,54.5,5,15,7,8,24,34,78,0,Matches
2051,Benjamin Pavard,fr FRA,DF,Inter,it Serie A,27,1996,18.6,34,21,21,11,2,20,24,83.3,4,25,15,10,32,66,44,1,Matches
2052,Jiří Pavlenka,cz CZE,GK,Werder Bremen,de Bundesliga,31,1992,7.0,0,0,0,0,0,0,0,,0,0,0,0,0,0,2,0,Matches
2053,Aleksandar Pavlovic,de GER,MF,Bayern Munich,de Bundesliga,19,2004,13.6,28,16,10,14,4,17,33,51.5,16,13,3,10,17,45,12,0,Matches
2054,Leonardo Pavoletti,it ITA,FW,Cagliari,it Serie A,34,1988,7.0,1,1,0,0,1,0,1,0.0,1,2,1,1,0,1,7,0,Matches
2055,Martín Payero,ar ARG,MF,Udinese,it Serie A,24,1998,20.0,54,32,28,19,7,19,46,41.3,27,25,7,18,15,69,21,0,Matches
2056,Nicolás Paz,ar ARG,"MF,FW",Real Madrid,es La Liga,18,2004,0.3,0,0,0,0,0,0,0,,0,2,0,2,1,1,0,0,Matches
2057,Myles Peart-Harris,eng ENG,"DF,MF",Brentford,eng Premier League,20,2002,0.1,0,0,0,0,0,0,0,,0,0,0,0,0,0,1,0,Matches
2058,Sydie Peck,eng ENG,MF,Sheffield Utd,eng Premier League,18,2004,0.1,0,0,0,0,0,0,0,,0,0,0,0,0,0,0,0,Matches
2059,Mads Pedersen,dk DEN,DF,Augsburg,de Bundesliga,26,1996,19.8,64,39,31,27,6,24,44,54.5,20,20,3,17,19,83,46,0,Matches
2060,Marcus Pedersen,no NOR,DF,Sassuolo,it Serie A,23,2000,17.9,36,24,25,5,6,21,25,84.0,4,19,5,14,10,46,51,0,Matches
2061,Alfonso Pedraza,es ESP,DF,Villarreal,es La Liga,27,1996,12.4,25,9,18,5,2,9,17,52.9,8,16,7,9,13,38,19,0,Matches
2062,Pedri,es ESP,"MF,FW",Barcelona,es La Liga,20,2002,16.4,33,24,16,13,4,8,27,29.6,19,27,3,24,14,47,10,0,Matches
2063,Pedro,es ESP,"FW,MF",Lazio,it Serie A,36,1987,9.1,16,12,5,7,4,3,12,25.0,9,16,2,14,3,19,1,0,Matches
2064,Adrià Pedrosa,es ESP,DF,Sevilla,es La Liga,25,1998,19.5,46,26,28,14,4,23,34,67.6,11,26,6,20,15,61,54,0,Matches
2065,Jordan Pefok,us USA,FW,Gladbach,de Bundesliga,27,1996,15.8,10,4,0,8,2,3,8,37.5,5,12,3,9,5,15,28,0,Matches
2066,Jordan Pefok,us USA,FW,Union Berlin,de Bundesliga,27,1996,0.3,0,0,0,0,0,0,0,,0,1,1,0,0,0,0,0,Matches
2067,Dženan Pejčinović,de GER,FW,Wolfsburg,de Bundesliga,18,2005,0.4,0,0,0,0,0,0,0,,0,1,0,1,0,0,0,0,Matches
2068,Pejiño,es ESP,FW,Las Palmas,es La Liga,27,1996,5.6,12,8,3,6,3,6,18,33.3,12,4,0,4,2,14,5,0,Matches
2069,Pietro Pellegri,it ITA,FW,Torino,it Serie A,22,2001,8.4,5,1,1,4,0,1,5,20.0,4,4,1,3,2,7,3,0,Matches
2070,Lorenzo Pellegrini,it ITA,MF,Roma,it Serie A,27,1996,20.7,35,20,14,16,5,17,51,33.3,34,28,5,23,20,55,22,0,Matches
2071,Luca Pellegrini,it ITA,DF,Lazio,it Serie A,24,1999,8.7,18,13,7,10,1,9,17,52.9,8,7,3,4,9,27,20,0,Matches
2072,Marco Pellegrino,ar ARG,DF,Salernitana,it Serie A,21,2002,6.1,8,6,4,3,1,5,10,50.0,5,11,6,5,10,18,28,0,Matches
2073,Marco Pellegrino,ar ARG,DF,Milan,it Serie A,21,2002,0.8,1,1,0,0,1,0,2,0.0,2,1,1,0,1,2,2,0,Matches
2074,Facundo Pellistri,uy URU,"FW,MF",Manchester Utd,eng Premier League,21,2001,1.9,5,3,4,1,0,1,3,33.3,2,7,1,6,1,6,5,0,Matches
2075,Facundo Pellistri,uy URU,"MF,FW",Granada,es La Liga,21,2001,13.7,29,19,12,10,7,6,21,28.6,15,18,0,18,4,33,7,0,Matches
2076,Andy Pelmard,mg MAD,DF,Clermont Foot,fr Ligue 1,23,2000,33.2,51,38,41,9,1,32,40,80.0,8,37,20,17,33,84,99,2,Matches
2077,Aurélien Pelon,fr FRA,DF,Lorient,fr Ligue 1,19,2004,1.0,1,0,1,0,0,0,2,0.0,2,2,2,0,0,1,7,0,Matches
2078,Faris Pemi Moumbagna,cm CMR,FW,Marseille,fr Ligue 1,23,2000,6.1,2,1,0,2,0,0,3,0.0,3,4,0,4,3,5,1,0,Matches
2079,Iñaki Peña,es ESP,GK,Barcelona,es La Liga,24,1999,10.0,0,0,0,0,0,0,1,0.0,1,0,0,0,0,0,5,1,Matches
2080,Marcos Peña,es ESP,MF,Almería,es La Liga,18,2005,4.9,19,14,12,7,0,6,12,50.0,6,9,3,6,13,32,8,0,Matches
2081,Rubén Peña,es ESP,"DF,FW",Osasuna,es La Liga,32,1991,23.2,47,25,22,18,7,20,49,40.8,29,37,8,29,30,77,39,3,Matches
2082,Pepín,gq EQG,"MF,FW",Monza,it Serie A,26,1996,2.7,6,1,1,4,1,2,4,50.0,2,5,2,3,0,6,6,0,Matches
2083,Alberto Perea,es ESP,"MF,FW",Granada,es La Liga,32,1990,0.0,0,0,0,0,0,0,2,0.0,2,0,0,0,0,0,0,0,Matches
2084,Andreas Pereira,br BRA,MF,Fulham,eng Premier League,27,1996,29.0,25,12,4,12,9,11,41,26.8,30,16,2,14,4,29,12,0,Matches
2085,Danilo Pereira,pt POR,DF,Paris S-G,fr Ligue 1,31,1991,22.2,22,12,14,6,2,9,17,52.9,8,29,26,3,23,45,100,1,Matches
2086,Mathias Pereira Lage,pt POR,"FW,MF",Brest,fr Ligue 1,26,1996,13.2,21,15,7,8,6,7,28,25.0,21,14,5,9,10,31,13,0,Matches
2087,Pedro Pereira,pt POR,DF,Monza,it Serie A,25,1998,9.3,19,13,14,4,1,9,17,52.9,8,15,2,13,4,23,18,0,Matches
2088,Daniel Peretz,il ISR,GK,Bayern Munich,de Bundesliga,23,2000,0.2,0,0,0,0,0,0,0,,0,0,0,0,0,0,0,0,Matches
2089,Roberto Pereyra,ar ARG,"FW,MF",Udinese,it Serie A,32,1991,20.6,19,9,11,5,3,11,29,37.9,18,20,4,16,7,26,18,0,Matches
2090,Ayoze Pérez,es ESP,FW,Betis,es La Liga,30,1993,25.5,59,32,16,33,10,21,49,42.9,28,42,4,38,22,81,18,0,Matches
2091,Carles Pérez,es ESP,"MF,DF",Celta Vigo,es La Liga,25,1998,8.6,13,5,6,5,2,7,18,38.9,11,14,1,13,5,18,8,0,Matches
2092,Francisco Perez,es ESP,"MF,FW",Valencia,es La Liga,20,2002,22.8,30,17,10,14,6,15,44,34.1,29,19,0,19,14,44,5,0,Matches
2093,Kike Pérez,es ESP,"MF,FW",Rayo Vallecano,es La Liga,26,1997,9.3,27,11,11,15,1,11,23,47.8,12,11,0,11,8,35,6,0,Matches
2094,Nehuén Pérez,ar ARG,DF,Udinese,it Serie A,23,2000,36.0,72,48,42,28,2,39,48,81.3,9,53,26,27,45,117,158,1,Matches
2095,Matteo Perez Vinlöf,se SWE,FW,Bayern Munich,de Bundesliga,17,2005,0.2,0,0,0,0,0,0,0,,0,0,0,0,1,1,0,0,Matches
2096,Simone Perilli,it ITA,GK,Hellas Verona,it Serie A,28,1995,1.0,0,0,0,0,0,0,0,,0,0,0,0,0,0,0,0,Matches
2097,Mattia Perin,it ITA,GK,Juventus,it Serie A,30,1992,2.5,0,0,0,0,0,0,0,,0,0,0,0,0,0,1,0,Matches
2098,Samuele Perisan,it ITA,GK,Empoli,it Serie A,25,1997,1.0,0,0,0,0,0,0,0,,0,0,0,0,0,0,0,0,Matches
2099,Ivan Perišić,hr CRO,FW,Tottenham,eng Premier League,34,1989,1.1,3,2,1,1,1,3,5,60.0,2,1,0,1,2,5,1,0,Matches
2100,Romain Perraud,fr FRA,"DF,FW",Nice,fr Ligue 1,25,1997,4.1,7,6,5,1,1,4,11,36.4,7,4,0,4,6,13,15,1,Matches
2101,Lucas Perrin,fr FRA,DF,Strasbourg,fr Ligue 1,24,1998,30.3,47,30,33,14,0,28,46,60.9,18,45,32,13,28,75,113,0,Matches
2102,Máximo Perrone,ar ARG,MF,Las Palmas,es La Liga,20,2003,18.0,42,21,17,22,3,19,39,48.7,20,27,4,23,24,66,21,0,Matches
2103,Pavao Pervan,at AUT,GK,Wolfsburg,de Bundesliga,35,1987,9.0,0,0,0,0,0,0,0,,0,0,0,0,0,0,4,0,Matches
2104,Matteo Pessina,it ITA,MF,Monza,it Serie A,26,1997,35.8,44,25,20,20,4,23,49,46.9,26,29,11,18,27,71,46,1,Matches
2105,Andrea Petagna,it ITA,FW,Cagliari,it Serie A,28,1995,11.1,4,2,1,0,3,1,2,50.0,1,6,3,3,1,5,4,0,Matches
2106,Denis Petrić,rs SRB,GK,Nantes,fr Ligue 1,35,1988,0.3,0,0,0,0,0,0,0,,0,0,0,0,0,0,0,0,Matches
2107,Njegoš Petrović,rs SRB,"MF,FW",Granada,es La Liga,24,1999,1.7,5,2,4,1,0,2,3,66.7,1,2,0,2,1,6,3,0,Matches
2108,Đorđe Petrović,rs SRB,GK,Chelsea,eng Premier League,23,1999,22.1,0,0,0,0,0,0,0,,0,0,0,0,0,0,12,3,Matches
2109,Jens Petter Hauge,no NOR,"MF,FW",Eint Frankfurt,de Bundesliga,23,1999,1.6,2,1,1,0,1,2,7,28.6,5,5,1,4,0,2,1,0,Matches
2110,Germán Pezzella,ar ARG,DF,Betis,es La Liga,32,1991,30.7,34,24,24,10,0,23,38,60.5,15,31,18,13,31,65,150,0,Matches
2111,Giuseppe Pezzella,it ITA,DF,Empoli,it Serie A,25,1997,12.1,25,14,19,5,1,20,28,71.4,8,17,6,11,2,27,35,0,Matches
2112,Luca Pfeiffer,de GER,"FW,MF",Darmstadt 98,de Bundesliga,26,1996,18.0,11,6,2,6,3,5,11,45.5,6,5,1,4,2,13,21,0,Matches
2113,Patric Pfeiffer,de GER,DF,Augsburg,de Bundesliga,23,1999,5.7,11,7,6,4,1,5,6,83.3,1,10,6,4,11,22,21,0,Matches
2114,Maximilian Philipp,de GER,"FW,MF",Freiburg,de Bundesliga,29,1994,3.6,8,5,4,4,0,1,6,16.7,5,7,0,7,1,9,3,0,Matches
2115,Kalvin Phillips,eng ENG,MF,West Ham,eng Premier League,27,1995,3.4,11,6,2,8,1,5,9,55.6,4,4,1,3,4,15,2,1,Matches
2116,Kalvin Phillips,eng ENG,MF,Manchester City,eng Premier League,27,1995,1.0,3,3,1,1,1,0,0,,0,0,0,0,2,5,2,0,Matches
2117,Jaden Philogene Bidace,eng ENG,FW,Aston Villa,eng Premier League,21,2002,0.0,0,0,0,0,0,0,0,,0,0,0,0,0,0,0,0,Matches
2118,Kamil Piątkowski,pl POL,DF,Granada,es La Liga,23,2000,5.6,18,10,16,1,1,10,14,71.4,4,6,5,1,8,26,28,1,Matches
2119,Roberto Piccoli,it ITA,FW,Empoli,it Serie A,22,2001,0.4,1,1,0,0,1,1,1,100.0,0,0,0,0,0,1,0,0,Matches
2120,Roberto Piccoli,it ITA,FW,Lecce,it Serie A,22,2001,15.3,10,6,3,5,2,1,4,25.0,3,17,1,16,4,14,16,0,Matches
2121,Florian Pick,de GER,"MF,FW",Heidenheim,de Bundesliga,27,1995,3.6,4,4,3,0,1,2,3,66.7,1,2,0,2,2,6,2,0,Matches
2122,Jordan Pickford,eng ENG,GK,Everton,eng Premier League,29,1994,38.0,1,0,1,0,0,1,1,100.0,0,3,0,3,0,1,19,1,Matches
2123,Amos Pieper,de GER,DF,Werder Bremen,de Bundesliga,25,1998,6.6,14,11,8,6,0,7,13,53.8,6,12,7,5,9,23,36,1,Matches
2124,Marvin Pieringer,de GER,"MF,FW",Heidenheim,de Bundesliga,23,1999,16.8,19,12,5,11,3,8,20,40.0,12,28,4,24,12,31,21,0,Matches
2125,Santiago Pierotti,ar ARG,"MF,FW",Lecce,it Serie A,22,2001,2.2,8,8,2,5,1,2,8,25.0,6,5,0,5,1,9,0,0,Matches
2126,Niccolò Pierozzi,it ITA,DF,Salernitana,it Serie A,21,2001,9.7,17,11,13,4,0,11,22,50.0,11,24,7,17,11,28,36,0,Matches
2127,Ronaël Pierre-Gabriel,fr FRA,DF,Nantes,fr Ligue 1,25,1998,6.6,15,9,12,2,1,5,7,71.4,2,13,4,9,8,23,25,0,Matches
2128,Andrea Pinamonti,it ITA,FW,Sassuolo,it Serie A,24,1999,34.2,13,8,1,6,6,5,22,22.7,17,19,2,17,1,14,40,0,Matches
2129,Ethan Pinnock,jm JAM,DF,Brentford,eng Premier League,30,1993,28.0,35,23,22,13,0,9,20,45.0,11,40,24,16,43,78,170,3,Matches
2130,Yeremi Pino,es ESP,"MF,FW",Villarreal,es La Liga,20,2002,5.3,25,18,12,10,3,9,18,50.0,9,11,1,10,5,30,5,0,Matches
2131,Carlo Pinsoglio,it ITA,GK,Juventus,it Serie A,33,1990,0.5,0,0,0,0,0,0,0,,0,0,0,0,0,0,0,0,Matches
2132,Lorenzo Pirola,it ITA,DF,Salernitana,it Serie A,21,2002,22.1,39,23,25,14,0,15,28,53.6,13,46,30,16,25,64,93,1,Matches
2133,Niccolò Pisilli,it ITA,MF,Roma,it Serie A,18,2004,0.1,0,0,0,0,0,0,0,,0,0,0,0,0,0,0,0,Matches
2134,Alassane Pléa,fr FRA,"FW,MF",Gladbach,de Bundesliga,30,1993,21.3,17,7,5,8,4,7,15,46.7,8,11,0,11,2,19,6,0,Matches
2135,Tommaso Pobega,it ITA,MF,Milan,it Serie A,24,1999,3.5,16,9,11,5,0,6,13,46.2,7,10,2,8,6,22,7,0,Matches
2136,Paul Pogba,fr FRA,MF,Juventus,it Serie A,30,1993,0.6,1,1,0,1,0,1,1,100.0,0,0,0,0,1,2,1,0,Matches
2137,Ole Pohlmann,de GER,MF,Dortmund,de Bundesliga,22,2001,0.6,1,0,0,1,0,1,2,50.0,1,0,0,0,0,1,1,0,Matches
2138,Matteo Politano,it ITA,FW,Napoli,it Serie A,29,1993,26.2,19,8,8,7,4,11,34,32.4,23,9,1,8,15,34,11,1,Matches
2139,Sebastian Polter,de GER,FW,Darmstadt 98,de Bundesliga,32,1991,5.0,1,0,1,0,0,0,1,0.0,1,5,1,4,0,1,4,0,Matches
2140,Julien Ponceau,fr FRA,MF,Lorient,fr Ligue 1,22,2000,24.9,32,15,12,14,6,9,30,30.0,21,22,1,21,19,51,20,0,Matches
2141,Marin Pongračić,hr CRO,DF,Lecce,it Serie A,25,1997,35.8,43,30,22,20,1,19,25,76.0,6,37,26,11,51,94,130,1,Matches
2142,Nick Pope,eng ENG,GK,Newcastle Utd,eng Premier League,31,1992,14.9,0,0,0,0,0,0,1,0.0,1,0,0,0,0,0,7,2,Matches
2143,Pedro Porro,es ESP,DF,Tottenham,eng Premier League,23,1999,34.3,91,63,43,34,14,62,120,51.7,58,63,18,45,34,125,102,3,Matches
2144,Portu,es ESP,FW,Getafe,es La Liga,31,1992,1.1,5,3,4,0,1,5,6,83.3,1,0,0,0,0,5,0,0,Matches
2145,Portu,es ESP,"MF,FW",Girona,es La Liga,31,1992,13.2,18,13,3,10,5,3,18,16.7,15,9,1,8,4,22,6,0,Matches
2146,Stefan Posch,at AUT,DF,Bologna,it Serie A,26,1997,26.8,77,46,35,38,4,49,88,55.7,39,27,8,19,18,95,72,0,Matches
2147,Yussuf Poulsen,dk DEN,FW,RB Leipzig,de Bundesliga,29,1994,13.5,13,8,1,9,3,4,14,28.6,10,13,3,10,4,17,15,0,Matches
2148,José Pozo,es ESP,MF,Rayo Vallecano,es La Liga,27,1996,0.2,1,1,0,1,0,1,1,100.0,0,1,0,1,0,1,0,0,Matches
2149,Alejandro Pozo Pozo,es ESP,"DF,MF",Almería,es La Liga,24,1999,10.8,19,12,11,6,2,12,20,60.0,8,14,4,10,7,26,21,0,Matches
2150,Beñat Prados,es ESP,"MF,DF",Athletic Club,es La Liga,22,2001,16.1,45,28,11,23,11,23,42,54.8,19,32,5,27,23,68,27,0,Matches
2151,Matteo Prati,it ITA,MF,Cagliari,it Serie A,19,2003,21.9,45,25,15,27,3,26,42,61.9,16,29,6,23,15,60,26,1,Matches
2152,Abdón Prats,es ESP,"FW,MF",Mallorca,es La Liga,30,1992,14.1,6,4,2,2,2,3,5,60.0,2,6,3,3,2,8,12,0,Matches
2153,Sanjin Prcić,ba BIH,MF,Strasbourg,fr Ligue 1,29,1993,1.0,0,0,0,0,0,0,1,0.0,1,2,1,1,3,3,1,0,Matches
2154,Grischa Prömel,de GER,MF,Hoffenheim,de Bundesliga,28,1995,23.8,32,18,11,15,6,14,32,43.8,18,22,6,16,22,54,36,0,Matches
2155,Ivan Provedel,it ITA,GK,Lazio,it Serie A,29,1994,30.0,1,0,1,0,0,1,3,33.3,2,0,0,0,0,1,12,1,Matches
2156,Marc Pubill,es ESP,DF,Almería,es La Liga,20,2003,20.9,47,23,35,8,4,22,39,56.4,17,20,8,12,15,62,83,1,Matches
2157,Gustavo Puerta,co COL,"DF,MF",Leverkusen,de Bundesliga,20,2003,0.5,5,3,2,2,1,1,2,50.0,1,2,0,2,0,5,0,0,Matches
2158,Antonio Puertas,es ESP,"MF,FW",Granada,es La Liga,31,1992,8.1,12,8,6,5,1,6,15,40.0,9,5,0,5,6,18,4,0,Matches
2159,Arnau Puigmal,es ESP,"FW,DF",Almería,es La Liga,22,2001,2.8,2,1,1,1,0,1,3,33.3,2,3,0,3,3,5,2,0,Matches
2160,Christian Pulisic,us USA,"FW,MF",Milan,it Serie A,24,1998,28.9,35,26,14,11,10,17,30,56.7,13,20,1,19,10,45,10,1,Matches
2161,George Pușcaș,ro ROU,FW,Genoa,it Serie A,27,1996,2.1,0,0,0,0,0,0,3,0.0,3,1,0,1,0,0,1,0,Matches
2162,Jarell Quansah,eng ENG,DF,Liverpool,eng Premier League,20,2003,13.2,25,22,17,7,1,14,20,70.0,6,16,8,8,17,42,39,1,Matches
2163,Domingos Quina,pt POR,MF,Udinese,it Serie A,23,1999,0.1,1,1,1,0,0,0,0,,0,0,0,0,0,1,0,0,Matches
2164,Adrien Rabiot,fr FRA,MF,Juventus,it Serie A,28,1995,29.5,58,39,22,30,6,30,45,66.7,15,26,6,20,25,83,34,0,Matches
2165,Uroš Račić,rs SRB,MF,Sassuolo,it Serie A,25,1998,9.1,10,4,6,4,0,0,9,0.0,9,16,7,9,7,17,22,0,Matches
2166,Nemanja Radonjić,rs SRB,"MF,FW",Torino,it Serie A,27,1996,4.2,1,1,0,0,1,1,3,33.3,2,3,0,3,0,1,0,0,Matches
2167,Nemanja Radonjić,rs SRB,"MF,DF",Mallorca,es La Liga,27,1996,3.9,4,2,1,3,0,1,4,25.0,3,2,0,2,3,7,3,0,Matches
2168,Aleksandar Radovanović,rs SRB,DF,Almería,es La Liga,29,1993,6.3,8,7,7,1,0,6,6,100.0,0,8,8,0,11,19,48,0,Matches
2169,Ionuț Radu,ro ROU,GK,Bournemouth,eng Premier League,26,1997,2.0,0,0,0,0,0,0,0,,0,0,0,0,0,0,0,0,Matches
2170,Boris Radunović,rs SRB,GK,Cagliari,it Serie A,27,1996,7.0,0,0,0,0,0,0,0,,0,0,0,0,1,1,1,2,Matches
2171,Hamza Rafia,tn TUN,MF,Lecce,it Serie A,24,1999,13.4,44,31,13,27,4,13,30,43.3,17,27,1,26,11,55,13,0,Matches
2172,Abdellah Raihani,ma MAR,FW,Atlético Madrid,es La Liga,19,2004,0.1,0,0,0,0,0,0,1,0.0,1,0,0,0,0,0,0,0,Matches
2173,Antonio Raillo,es ESP,DF,Mallorca,es La Liga,31,1991,24.4,30,23,18,12,0,17,23,73.9,6,44,30,14,37,67,104,2,Matches
2174,Luca Raimund,de GER,"FW,MF",Stuttgart,de Bundesliga,18,2005,0.3,3,1,2,1,0,0,0,,0,2,0,2,0,3,0,0,Matches
2175,Predrag Rajković,rs SRB,GK,Mallorca,es La Liga,27,1995,36.0,2,1,2,0,0,2,2,100.0,0,0,0,0,0,2,14,0,Matches
2176,Jesurun Rak Sakyi,eng ENG,"MF,FW",Crystal Palace,eng Premier League,20,2002,1.5,4,1,3,1,0,2,3,66.7,1,2,0,2,3,7,1,0,Matches
2177,Ivan Rakitić,hr CRO,MF,Sevilla,es La Liga,35,1988,15.8,30,16,9,12,9,11,19,57.9,8,16,5,11,14,44,12,0,Matches
2178,Ylber Ramadani,al ALB,MF,Lecce,it Serie A,27,1996,33.0,68,41,32,29,7,37,96,38.5,59,54,13,41,44,112,44,0,Matches
2179,Largie Ramazani,be BEL,"FW,MF",Almería,es La Liga,22,2001,17.3,12,7,5,6,1,6,26,23.1,20,16,2,14,34,46,10,0,Matches
2180,Benito Ramírez,es ESP,"FW,MF",Las Palmas,es La Liga,28,1995,4.3,5,3,2,3,0,3,6,50.0,3,7,1,6,3,8,0,0,Matches
2181,Sandro Ramírez,es ESP,FW,Las Palmas,es La Liga,28,1995,20.1,12,8,4,6,2,6,15,40.0,9,13,1,12,4,16,14,1,Matches
2182,Chris Ramos,es ESP,"FW,MF",Cádiz,es La Liga,26,1997,29.0,28,15,9,15,4,8,27,29.6,19,23,7,16,9,37,44,0,Matches
2183,Gonçalo Ramos,pt POR,FW,Paris S-G,fr Ligue 1,22,2001,15.8,25,15,4,12,9,6,20,30.0,14,12,2,10,5,30,16,0,Matches
2184,Sergio Ramos,es ESP,DF,Sevilla,es La Liga,37,1986,28.0,45,30,32,11,2,27,40,67.5,13,35,30,5,41,86,156,0,Matches
2185,Aaron Ramsdale,eng ENG,GK,Arsenal,eng Premier League,25,1998,6.0,0,0,0,0,0,0,0,,0,0,0,0,0,0,3,2,Matches
2186,Aaron Ramsey,eng ENG,"MF,FW",Burnley,eng Premier League,20,2003,5.9,17,14,7,5,5,8,16,50.0,8,11,2,9,1,18,10,0,Matches
2187,Jacob Ramsey,eng ENG,"FW,MF",Aston Villa,eng Premier League,22,2001,9.5,16,8,7,6,3,5,15,33.3,10,15,2,13,3,19,8,0,Matches
2188,Luca Ranieri,it ITA,DF,Fiorentina,it Serie A,24,1999,22.9,14,10,11,1,2,8,13,61.5,5,25,11,14,29,43,64,0,Matches
2189,Filippo Ranocchia,it ITA,"MF,DF",Empoli,it Serie A,22,2001,5.3,16,11,7,9,0,7,16,43.8,9,9,1,8,3,19,14,0,Matches
2190,Grant Ranos,am ARM,"MF,FW",Gladbach,de Bundesliga,20,2003,0.5,1,0,0,0,1,0,0,,0,0,0,0,0,1,0,0,Matches
2191,Raphinha,br BRA,"FW,MF",Barcelona,es La Liga,26,1996,15.2,14,8,6,6,2,4,18,22.2,14,17,1,16,13,27,11,0,Matches
2192,Nicolai Rapp,de GER,DF,Werder Bremen,de Bundesliga,26,1996,0.8,3,2,2,1,0,2,2,100.0,0,2,0,2,2,5,8,0,Matches
2193,Elba Rashani,xk KVX,"MF,FW",Clermont Foot,fr Ligue 1,30,1993,13.1,30,18,4,17,9,11,24,45.8,13,17,3,14,12,42,15,0,Matches
2194,Marcus Rashford,eng ENG,FW,Manchester Utd,eng Premier League,25,1997,25.2,19,12,9,4,6,9,26,34.6,17,15,1,14,4,23,21,0,Matches
2195,Giacomo Raspadori,it ITA,"FW,MF",Napoli,it Serie A,23,2000,17.6,21,10,6,10,5,6,15,40.0,9,15,1,14,3,24,7,0,Matches
2196,Andrei Ratiu,ro ROU,"DF,MF",Rayo Vallecano,es La Liga,25,1998,7.0,12,4,6,5,1,8,15,53.3,7,4,1,3,0,12,12,0,Matches
2197,Raúl,es ESP,FW,Osasuna,es La Liga,22,2000,15.1,10,4,4,2,4,2,10,20.0,8,9,1,8,5,15,11,0,Matches
2198,David Raum,de GER,DF,RB Leipzig,de Bundesliga,25,1998,30.4,58,35,24,29,5,34,58,58.6,24,51,9,42,27,85,82,2,Matches
2199,Federico Ravaglia,it ITA,GK,Bologna,it Serie A,23,1999,5.9,0,0,0,0,0,0,0,,0,0,0,0,0,0,2,0,Matches
2200,David Raya,es ESP,GK,Arsenal,eng Premier League,27,1995,32.0,1,1,1,0,0,1,1,100.0,0,0,0,0,0,1,8,5,Matches
2201,Tim Ream,us USA,DF,Fulham,eng Premier League,35,1987,16.7,20,9,13,5,2,9,18,50.0,9,23,15,8,25,45,61,2,Matches
2202,Abde Rebbach,dz ALG,"FW,MF",Alavés,es La Liga,24,1998,8.0,9,5,4,2,3,5,15,33.3,10,10,1,9,3,12,7,0,Matches
2203,Nathan Redmond,eng ENG,"FW,MF",Burnley,eng Premier League,29,1994,1.6,2,1,0,0,2,1,4,25.0,3,1,0,1,0,2,3,0,Matches
2204,Harrison Reed,eng ENG,MF,Fulham,eng Premier League,28,1995,14.7,29,18,9,17,3,13,31,41.9,18,19,9,10,11,40,24,0,Matches
2205,Sergio Reguilón,es ESP,DF,Manchester Utd,eng Premier League,26,1996,4.6,13,8,6,2,5,8,17,47.1,9,10,0,10,5,18,7,0,Matches
2206,Sergio Reguilón,es ESP,DF,Brentford,eng Premier League,26,1996,12.4,45,20,26,18,1,24,40,60.0,16,23,6,17,16,61,41,1,Matches
2207,Tijjani Reijnders,nl NED,MF,Milan,it Serie A,25,1998,31.3,46,25,10,31,5,21,43,48.8,22,26,8,18,18,64,26,0,Matches
2208,Pepe Reina,es ESP,GK,Villarreal,es La Liga,40,1982,2.0,0,0,0,0,0,0,0,,0,0,0,0,0,0,1,0,Matches
2209,Reinier,br BRA,"MF,FW",Frosinone,it Serie A,21,2002,11.8,21,10,6,12,3,5,17,29.4,12,24,4,20,10,31,5,0,Matches
2210,Rocco Reitz,de GER,MF,Gladbach,de Bundesliga,21,2002,23.7,61,36,28,29,4,28,55,50.9,27,61,20,41,44,105,31,1,Matches
2211,Álex Remiro,es ESP,GK,Real Sociedad,es La Liga,28,1995,36.4,0,0,0,0,0,0,0,,0,0,0,0,0,0,24,2,Matches
2212,Guillaume Restes,fr FRA,GK,Toulouse,fr Ligue 1,18,2005,34.0,0,0,0,0,0,0,3,0.0,3,0,0,0,0,0,19,1,Matches
2213,Mateo Retegui,it ITA,FW,Genoa,it Serie A,24,1999,24.6,17,9,7,8,2,6,20,30.0,14,18,2,16,0,17,30,0,Matches
2214,Marco Reus,de GER,"MF,FW",Dortmund,de Bundesliga,34,1989,17.8,37,25,20,14,3,12,27,44.4,15,17,2,15,5,42,18,0,Matches
2215,Elvis Rexhbeçaj,xk KVX,MF,Augsburg,de Bundesliga,25,1997,22.1,30,19,14,13,3,18,36,50.0,18,32,7,25,20,50,20,0,Matches
2216,Gio Reyna,us USA,"FW,MF",Nott'ham Forest,eng Premier League,20,2002,2.6,7,3,4,0,3,3,6,50.0,3,3,0,3,2,9,0,0,Matches
2217,Gio Reyna,us USA,"MF,FW",Dortmund,de Bundesliga,20,2002,3.1,9,6,3,4,2,2,5,40.0,3,5,1,4,2,11,5,0,Matches
2218,Chadi Riad,ma MAR,DF,Betis,es La Liga,20,2003,24.0,35,24,17,18,0,17,27,63.0,10,23,14,9,23,58,108,0,Matches
2219,Alexsandro Ribeiro,br BRA,DF,Lille,fr Ligue 1,23,1999,24.7,32,22,24,8,0,16,31,51.6,15,25,15,10,35,67,116,5,Matches
2220,Rodrigo Ribeiro,pt POR,"MF,FW",Nott'ham Forest,eng Premier League,18,2005,0.2,0,0,0,0,0,0,1,0.0,1,1,0,1,1,1,0,0,Matches
2221,Samuele Ricci,it ITA,MF,Torino,it Serie A,21,2001,26.6,33,18,17,12,4,15,23,65.2,8,21,3,18,27,60,25,0,Matches
2222,Declan Rice,eng ENG,MF,Arsenal,eng Premier League,24,1999,35.8,83,51,37,38,8,32,57,56.1,25,37,11,26,44,127,52,0,Matches
2223,Chris Richards,us USA,"DF,MF",Crystal Palace,eng Premier League,23,2000,23.3,46,28,21,22,3,20,30,66.7,10,32,12,20,27,73,109,0,Matches
2224,Amir Richardson,ma MAR,MF,Reims,fr Ligue 1,21,2002,15.0,33,23,12,18,3,10,22,45.5,12,26,5,21,15,48,30,0,Matches
2225,Richarlison,br BRA,FW,Tottenham,eng Premier League,26,1997,16.6,16,11,4,8,4,2,10,20.0,8,32,6,26,8,24,23,0,Matches
2226,Marco Richter,de GER,"MF,FW",Mainz 05,de Bundesliga,25,1997,8.0,10,4,5,3,2,4,11,36.4,7,9,0,9,2,12,1,0,Matches
2227,Diego Rico,es ESP,DF,Getafe,es La Liga,30,1993,28.2,64,48,32,23,9,41,76,53.9,35,25,8,17,41,105,76,0,Matches
2228,Clemens Riedel,de GER,DF,Darmstadt 98,de Bundesliga,20,2003,8.4,22,13,16,5,1,15,24,62.5,9,11,3,8,11,33,26,0,Matches
2229,Fabian Rieder,ch SUI,MF,Rennes,fr Ligue 1,21,2002,4.1,13,7,2,9,2,6,11,54.5,5,3,1,2,5,18,2,0,Matches
2230,Jaïro Riedewald,nl NED,"MF,FW",Crystal Palace,eng Premier League,26,1996,2.6,9,3,2,4,3,3,6,50.0,3,0,0,0,2,11,2,0,Matches
2231,Manuel Riemann,de GER,GK,Bochum,de Bundesliga,34,1988,33.0,2,1,2,0,0,2,4,50.0,2,0,0,0,1,3,25,1,Matches
2232,Luis Rioja,es ESP,"FW,MF",Alavés,es La Liga,29,1993,27.8,27,19,10,12,5,14,43,32.6,29,28,1,27,16,43,28,0,Matches
2233,Rémy Riou,fr FRA,GK,Lyon,fr Ligue 1,35,1987,3.0,0,0,0,0,0,0,1,0.0,1,0,0,0,0,0,1,1,Matches
2234,Rodrigo Riquelme,es ESP,"DF,MF",Atlético Madrid,es La Liga,23,2000,17.0,30,19,18,4,8,18,46,39.1,28,19,0,19,9,39,20,0,Matches
2235,Alberto Risco,es ESP,MF,Getafe,es La Liga,17,2005,1.5,2,2,1,1,0,0,4,0.0,4,0,0,0,0,2,1,0,Matches
2236,Mihailo Ristić,rs SRB,"DF,MF",Celta Vigo,es La Liga,27,1995,9.0,15,9,9,6,0,9,12,75.0,3,9,2,7,10,25,23,0,Matches
2237,Matt Ritchie,sct SCO,"FW,MF",Newcastle Utd,eng Premier League,33,1989,1.4,5,3,2,2,1,2,4,50.0,2,3,2,1,1,6,5,0,Matches
2238,Gorka Rivera Alonso,es ESP,DF,Getafe,es La Liga,18,2004,0.0,0,0,0,0,0,0,0,,0,0,0,0,0,0,0,0,Matches
2239,Sergi Roberto,es ESP,"MF,DF",Barcelona,es La Liga,31,1992,9.6,15,10,4,10,1,3,11,27.3,8,7,2,5,8,23,7,1,Matches
2240,Lucas Robertone,ar ARG,MF,Almería,es La Liga,26,1997,26.5,61,33,28,23,10,25,50,50.0,25,43,9,34,51,112,43,0,Matches
2241,Connor Roberts,wls WAL,DF,Burnley,eng Premier League,27,1995,9.1,12,5,6,4,2,8,17,47.1,9,8,6,2,4,16,25,2,Matches
2242,Andrew Robertson,sct SCO,DF,Liverpool,eng Premier League,29,1994,18.8,35,24,21,11,3,26,43,60.5,17,20,6,14,13,48,40,0,Matches
2243,Antonee Robinson,us USA,DF,Fulham,eng Premier League,25,1997,36.3,93,58,60,26,7,52,110,47.3,58,56,8,48,80,173,117,3,Matches
2244,Jack Robinson,eng ENG,DF,Sheffield Utd,eng Premier League,29,1993,32.1,43,28,29,14,0,25,39,64.1,14,49,33,16,33,76,132,2,Matches
2245,Marc Roca,es ESP,MF,Betis,es La Liga,26,1996,22.0,52,36,17,29,6,30,53,56.6,23,29,6,23,17,69,23,1,Matches
2246,Sebastian Rode,de GER,MF,Eint Frankfurt,de Bundesliga,32,1990,0.7,6,4,0,5,1,4,6,66.7,2,0,0,0,1,7,1,0,Matches
2247,Sergio Rodelas,es ESP,"FW,DF",Granada,es La Liga,18,2004,1.4,3,2,1,0,2,0,3,0.0,3,0,0,0,0,3,0,0,Matches
2248,Rodri,es ESP,MF,Manchester City,eng Premier League,27,1996,32.6,70,43,25,33,12,29,60,48.3,31,32,8,24,26,96,41,4,Matches
2249,Rodri,es ESP,"FW,MF",Betis,es La Liga,23,2000,11.7,17,10,6,7,4,8,21,38.1,13,11,0,11,8,25,2,0,Matches
2250,Álvaro Rodríguez,uy URU,FW,Real Madrid,es La Liga,19,2004,0.0,0,0,0,0,0,0,0,,0,0,0,0,0,0,1,0,Matches
2251,Óscar Rodríguez Arnaiz,es ESP,"MF,FW",Getafe,es La Liga,25,1998,10.7,24,13,2,15,7,9,15,60.0,6,12,1,11,5,29,5,0,Matches
2252,Damián Rodríguez,es ESP,MF,Celta Vigo,es La Liga,20,2003,2.9,6,3,1,3,2,1,3,33.3,2,4,2,2,1,7,2,0,Matches
2253,Dani Rodríguez,es ESP,MF,Mallorca,es La Liga,35,1988,29.1,47,24,21,20,6,21,45,46.7,24,34,5,29,15,62,21,0,Matches
2254,Guido Rodríguez,ar ARG,MF,Betis,es La Liga,29,1994,20.5,53,30,21,24,8,34,55,61.8,21,27,6,21,29,82,44,0,Matches
2255,Jay Rodriguez,eng ENG,FW,Burnley,eng Premier League,34,1989,9.1,14,9,7,4,3,7,13,53.8,6,11,1,10,1,15,8,0,Matches
2256,Kirian Rodríguez,es ESP,MF,Las Palmas,es La Liga,27,1996,35.7,52,32,22,25,5,24,67,35.8,43,39,3,36,28,80,23,1,Matches
2257,Miguel Rodríguez,es ESP,MF,Celta Vigo,es La Liga,20,2003,3.3,6,3,3,1,2,3,9,33.3,6,8,0,8,4,10,0,0,Matches
2258,Ricardo Rodríguez,ch SUI,DF,Torino,it Serie A,30,1992,30.8,45,26,21,22,2,28,45,62.2,17,22,9,13,24,69,64,2,Matches
2259,Rodrygo,br BRA,FW,Real Madrid,es La Liga,22,2001,26.4,16,15,2,9,5,5,19,26.3,14,14,0,14,8,24,6,0,Matches
2260,Mads Roerslev,dk DEN,DF,Brentford,eng Premier League,24,1999,22.1,48,31,34,9,5,27,54,50.0,27,15,3,12,19,67,71,0,Matches
2261,Rogério,br BRA,DF,Wolfsburg,de Bundesliga,25,1998,10.1,14,6,7,5,2,10,14,71.4,4,16,5,11,5,19,23,1,Matches
2262,Morgan Rogers,eng ENG,"MF,FW",Aston Villa,eng Premier League,21,2002,7.1,8,1,3,2,3,2,11,18.2,9,11,0,11,3,11,11,0,Matches
2263,Merlin Röhl,de GER,"MF,FW",Freiburg,de Bundesliga,21,2002,16.4,21,13,10,9,2,8,21,38.1,13,27,3,24,9,30,22,0,Matches
2264,Alessio Romagnoli,it ITA,DF,Lazio,it Serie A,28,1995,26.8,25,18,14,11,0,16,24,66.7,8,29,17,12,29,54,115,0,Matches
2265,Simone Romagnoli,it ITA,DF,Frosinone,it Serie A,33,1990,30.2,35,15,23,11,1,15,20,75.0,5,51,36,15,29,64,147,0,Matches
2266,Carlos Romero,es ESP,DF,Villarreal,es La Liga,21,2001,2.9,11,5,8,1,2,7,12,58.3,5,3,0,3,1,12,11,0,Matches
2267,Cristian Romero,ar ARG,DF,Tottenham,eng Premier League,25,1998,31.0,66,40,35,25,6,32,44,72.7,12,46,22,24,44,110,106,1,Matches
2268,Isaac Romero,es ESP,FW,Sevilla,es La Liga,23,2000,11.5,6,3,2,2,2,5,9,55.6,4,12,0,12,0,6,11,0,Matches
2269,Luka Romero,ar ARG,"FW,MF",Milan,it Serie A,18,2004,1.0,0,0,0,0,0,0,3,0.0,3,2,0,2,0,0,0,0,Matches
2270,Luka Romero,ar ARG,FW,Almería,es La Liga,18,2004,4.9,5,1,2,3,0,2,4,50.0,2,12,1,11,1,6,2,1,Matches
2271,Oriol Romeu,es ESP,MF,Barcelona,es La Liga,31,1991,10.4,34,20,17,14,3,13,24,54.2,11,12,2,10,10,44,18,0,Matches
2272,Valentin Rongier,fr FRA,MF,Marseille,fr Ligue 1,28,1994,9.5,23,12,9,12,2,14,26,53.8,12,16,4,12,15,38,18,0,Matches
2273,Frank Ronstadt,de GER,"DF,MF",Darmstadt 98,de Bundesliga,26,1997,0.8,1,0,0,1,0,0,1,0.0,1,1,0,1,1,2,3,0,Matches
2274,Marten de Roon,nl NED,"MF,DF",Atalanta,it Serie A,32,1991,28.9,80,43,36,32,12,35,82,42.7,47,36,10,26,40,120,54,0,Matches
2275,Unai Ropero,es ESP,MF,Alavés,es La Liga,21,2001,0.1,0,0,0,0,0,0,0,,0,0,0,0,0,0,0,0,Matches
2276,Vitor Roque,br BRA,FW,Barcelona,es La Liga,18,2005,3.6,3,2,2,0,1,0,2,0.0,2,3,0,3,0,3,5,0,Matches
2277,Pablo Rosario,do DOM,"MF,DF",Nice,fr Ligue 1,26,1997,22.3,36,25,15,16,5,23,34,67.6,11,27,13,14,29,65,39,0,Matches
2278,Valentin Rosier,fr FRA,"DF,MF",Nice,fr Ligue 1,26,1996,0.6,1,0,1,0,0,0,0,,0,1,0,1,2,3,5,0,Matches
2279,Francesco Rossi,it ITA,GK,Atalanta,it Serie A,32,1991,0.1,0,0,0,0,0,0,0,,0,0,0,0,0,0,0,0,Matches
2280,Joe Rothwell,eng ENG,MF,Bournemouth,eng Premier League,28,1995,4.3,7,2,4,2,1,2,8,25.0,6,4,2,2,3,10,2,0,Matches
2281,Anthony Rouault,fr FRA,DF,Stuttgart,de Bundesliga,22,2001,11.2,21,12,14,5,2,13,21,61.9,8,14,8,6,8,29,28,0,Matches
2282,Jérôme Roussillon,fr FRA,DF,Union Berlin,de Bundesliga,30,1993,8.4,16,9,6,7,3,8,12,66.7,4,13,4,9,5,21,26,0,Matches
2283,Nicolò Rovella,it ITA,MF,Lazio,it Serie A,21,2001,14.6,46,28,25,17,4,16,36,44.4,20,27,6,21,23,69,29,0,Matches
2284,Amir Rrahmani,xk KVX,DF,Napoli,it Serie A,29,1994,28.9,33,27,17,14,2,16,32,50.0,16,24,10,14,20,53,90,0,Matches
2285,Ruan,br BRA,DF,Sassuolo,it Serie A,24,1999,16.8,25,15,11,10,4,10,18,55.6,8,18,15,3,24,49,68,2,Matches
2286,Pelly Ruddock Mpanzu,cd COD,MF,Luton Town,eng Premier League,30,1993,12.2,13,5,6,6,1,5,9,55.6,4,15,7,8,9,22,16,3,Matches
2287,Antonio Rüdiger,de GER,DF,Real Madrid,es La Liga,30,1993,30.1,26,15,18,4,4,16,20,80.0,4,27,20,7,11,37,89,0,Matches
2288,Fabian Rüdlin,de GER,MF,Freiburg,de Bundesliga,26,1997,0.1,1,0,0,0,1,0,0,,0,0,0,0,0,1,0,0,Matches
2289,Javier Rueda Garcia,es ESP,"MF,DF",Celta Vigo,es La Liga,21,2002,0.2,0,0,0,0,0,0,0,,0,0,0,0,0,0,0,0,Matches
2290,Daniele Rugani,it ITA,DF,Juventus,it Serie A,29,1994,13.2,11,9,7,3,1,4,5,80.0,1,11,4,7,9,20,42,0,Matches
2291,Matteo Ruggeri,it ITA,DF,Atalanta,it Serie A,21,2002,27.2,29,15,14,7,8,16,30,53.3,14,46,4,42,23,52,44,0,Matches
2292,Mário Rui,pt POR,DF,Napoli,it Serie A,32,1991,13.4,27,15,17,5,5,14,21,66.7,7,17,2,15,15,42,19,0,Matches
2293,Aitor Ruibal,es ESP,"DF,FW",Betis,es La Liga,27,1996,11.3,46,27,28,13,5,32,59,54.2,27,12,1,11,14,60,33,1,Matches
2294,Fabián Ruiz Peña,es ESP,MF,Paris S-G,fr Ligue 1,27,1996,13.3,34,23,17,14,3,23,42,54.8,19,8,2,6,11,45,21,2,Matches
2295,Sergio Ruiz,es ESP,MF,Granada,es La Liga,28,1994,27.7,83,46,43,36,4,38,84,45.2,46,24,6,18,28,111,43,1,Matches
2296,Julian Ryerson,no NOR,DF,Dortmund,de Bundesliga,25,1997,19.6,41,23,26,11,4,27,47,57.4,20,31,7,24,10,51,35,3,Matches
2297,Frederik Rønnow,dk DEN,GK,Union Berlin,de Bundesliga,30,1992,33.0,1,1,1,0,0,0,0,,0,0,0,0,1,2,20,2,Matches
2298,José Sá,pt POR,GK,Wolves,eng Premier League,30,1993,33.7,0,0,0,0,0,0,1,0.0,1,3,0,3,0,0,21,5,Matches
2299,Youssouf Sabaly,sn SEN,DF,Betis,es La Liga,30,1993,11.6,16,11,12,3,1,8,12,66.7,4,6,3,3,11,27,27,0,Matches
2300,Emmanuel Sabbi,us USA,"FW,MF",Le Havre,fr Ligue 1,25,1997,17.6,38,19,15,15,8,16,39,41.0,23,26,2,24,19,57,7,0,Matches
2301,Stefano Sabelli,it ITA,DF,Genoa,it Serie A,30,1993,27.0,50,24,28,19,3,15,46,32.6,31,27,6,21,23,73,35,0,Matches
2302,Marcel Sabitzer,at AUT,MF,Dortmund,de Bundesliga,29,1994,21.8,39,24,18,20,1,23,42,54.8,19,31,12,19,12,51,34,0,Matches
2303,Falaye Sacko,ml MLI,DF,Montpellier,fr Ligue 1,28,1995,15.4,28,16,13,10,5,21,32,65.6,11,19,7,12,24,52,37,0,Matches
2304,Dominic Sadi,eng ENG,FW,Bournemouth,eng Premier League,19,2003,0.0,0,0,0,0,0,0,0,,0,0,0,0,0,0,0,0,Matches
2305,Umar Sadiq,ng NGA,FW,Real Sociedad,es La Liga,26,1997,12.0,15,10,2,8,5,4,8,50.0,4,9,0,9,0,15,10,0,Matches
2306,Alexis Saelemaekers,be BEL,"FW,MF",Bologna,it Serie A,24,1999,21.0,32,22,13,14,5,12,27,44.4,15,13,1,12,13,45,10,1,Matches
2307,Pablo Saenz,es ESP,MF,Granada,es La Liga,22,2001,0.2,3,3,2,0,1,1,3,33.3,2,0,0,0,0,3,0,0,Matches
2308,Modibo Sagnan,ml MLI,DF,Montpellier,fr Ligue 1,24,1999,11.7,34,22,23,9,2,15,25,60.0,10,13,9,4,15,49,67,0,Matches
2309,Moïse Sahi Dion,ci CIV,"MF,FW",Strasbourg,fr Ligue 1,21,2001,7.0,5,5,1,2,2,0,3,0.0,3,11,1,10,1,6,7,0,Matches
2310,Wesley Saïd,fr FRA,"FW,MF",Lens,fr Ligue 1,28,1995,11.3,8,4,1,2,5,2,9,22.2,7,4,0,4,4,12,3,0,Matches
2311,Théo Sainte-Luce,fr FRA,DF,Montpellier,fr Ligue 1,24,1998,3.8,17,7,10,6,1,11,19,57.9,8,9,4,5,3,20,15,0,Matches
2312,Bukayo Saka,eng ENG,FW,Arsenal,eng Premier League,21,2001,32.4,66,35,22,24,20,26,59,44.1,33,43,2,41,15,81,24,1,Matches
2313,Mamadou Sakho,fr FRA,DF,Montpellier,fr Ligue 1,33,1990,0.1,1,1,1,0,0,1,1,100.0,0,0,0,0,0,1,1,0,Matches
2314,Ibrahim Salah,ma MAR,"FW,MF",Rennes,fr Ligue 1,21,2001,5.8,15,7,5,6,4,11,18,61.1,7,4,0,4,10,25,5,0,Matches
2315,Mohamed Salah,eg EGY,FW,Liverpool,eng Premier League,31,1992,28.2,17,11,1,8,8,6,21,28.6,15,19,1,18,2,19,1,0,Matches
2316,Amine Salama,fr FRA,FW,Reims,fr Ligue 1,23,2000,3.5,0,0,0,0,0,0,0,,0,1,0,1,1,1,1,0,Matches
2317,Kike Salas,es ESP,DF,Sevilla,es La Liga,21,2002,17.8,41,23,26,12,3,22,36,61.1,14,25,14,11,26,67,91,1,Matches
2318,William Saliba,fr FRA,DF,Arsenal,eng Premier League,22,2001,38.0,41,26,28,12,1,20,27,74.1,7,32,17,15,29,70,81,3,Matches
2319,Mohammed Salisu,gh GHA,DF,Monaco,fr Ligue 1,24,1999,11.5,27,12,11,13,3,17,26,65.4,9,21,12,9,22,49,44,0,Matches
2320,Roland Sallai,hu HUN,"MF,FW",Freiburg,de Bundesliga,26,1997,20.4,17,10,5,5,7,8,20,40.0,12,21,1,20,6,23,23,0,Matches
2321,Yoann Salmier,gf GUF,DF,Le Havre,fr Ligue 1,30,1992,17.4,22,10,13,6,3,13,20,65.0,7,21,15,6,21,43,57,0,Matches
2322,Salvi,es ESP,MF,Rayo Vallecano,es La Liga,32,1991,0.3,0,0,0,0,0,0,4,0.0,4,0,0,0,1,1,0,0,Matches
2323,Lazar Samardzic,rs SRB,MF,Udinese,it Serie A,21,2002,26.4,40,19,18,18,4,16,39,41.0,23,26,6,20,10,50,25,0,Matches
2324,Diadie Samassékou,ml MLI,MF,Cádiz,es La Liga,27,1996,1.0,5,3,2,2,1,5,6,83.3,1,0,0,0,3,8,1,0,Matches
2325,Diadie Samassékou,ml MLI,MF,Hoffenheim,de Bundesliga,27,1996,0.0,0,0,0,0,0,0,0,,0,0,0,0,1,1,0,0,Matches
2326,Mama Samba Baldé,gw GNB,"FW,MF",Lyon,fr Ligue 1,27,1995,6.1,8,5,1,2,5,3,9,33.3,6,0,0,0,3,11,1,1,Matches
2327,Brice Samba,fr FRA,GK,Lens,fr Ligue 1,29,1994,33.0,1,1,1,0,0,1,1,100.0,0,0,0,0,0,1,10,3,Matches
2328,Albert Sambi Lokonga,be BEL,MF,Luton Town,eng Premier League,23,1999,14.5,29,18,14,12,3,17,24,70.8,7,23,13,10,11,40,14,0,Matches
2329,Junior Sambia,fr FRA,"DF,MF",Salernitana,it Serie A,26,1996,11.5,12,5,8,1,3,6,11,54.5,5,15,7,8,11,23,28,0,Matches
2330,Fede San Emeterio,es ESP,MF,Cádiz,es La Liga,26,1997,1.7,3,2,2,1,0,1,4,25.0,3,3,2,1,2,5,1,0,Matches
2331,Antonio Sanabria,py PAR,"FW,MF",Torino,it Serie A,27,1996,23.7,18,15,5,9,4,4,9,44.4,5,7,1,6,6,24,12,0,Matches
2332,Oihan Sancet,es ESP,MF,Athletic Club,es La Liga,23,2000,21.9,19,11,3,10,6,8,21,38.1,13,5,1,4,10,29,5,0,Matches
2333,Renato Sanches,pt POR,MF,Roma,it Serie A,25,1997,1.6,2,1,1,1,0,2,3,66.7,1,2,0,2,0,2,1,0,Matches
2334,Ricard Sánchez,es ESP,DF,Granada,es La Liga,23,2000,25.5,29,18,15,8,6,12,24,50.0,12,32,4,28,13,42,64,0,Matches
2335,Alexis Sánchez,cl CHI,"FW,MF",Inter,it Serie A,34,1988,8.5,7,6,0,5,2,1,4,25.0,3,4,1,3,1,8,3,0,Matches
2336,Antonio Sánchez,es ESP,MF,Mallorca,es La Liga,26,1997,16.1,25,11,13,10,2,11,32,34.4,21,24,5,19,13,38,13,0,Matches
2337,Davinson Sánchez,co COL,DF,Tottenham,eng Premier League,27,1996,0.9,0,0,0,0,0,0,0,,0,3,2,1,1,1,2,0,Matches
2338,Juanlu Sánchez,es ESP,DF,Sevilla,es La Liga,19,2003,13.1,56,35,34,18,4,34,58,58.6,24,24,7,17,12,68,36,0,Matches
2339,Manu Sánchez,es ESP,"DF,MF",Celta Vigo,es La Liga,22,2000,19.7,54,28,21,25,8,31,55,56.4,24,23,3,20,19,73,65,0,Matches
2340,Robert Sánchez,es ESP,GK,Chelsea,eng Premier League,25,1997,15.9,0,0,0,0,0,0,0,,0,0,0,0,0,0,11,3,Matches
2341,Jadon Sancho,eng ENG,"FW,MF",Manchester Utd,eng Premier League,23,2000,0.9,1,0,1,0,0,1,3,33.3,2,1,0,1,1,2,0,0,Matches
2342,Jadon Sancho,eng ENG,"FW,MF",Dortmund,de Bundesliga,23,2000,10.5,5,4,1,3,1,0,4,0.0,4,11,0,11,4,9,6,0,Matches
2343,Alex Sandro,br BRA,DF,Juventus,it Serie A,32,1991,8.0,13,7,7,6,0,4,5,80.0,1,13,7,6,15,28,23,0,Matches
2344,Ibou Sané,sn SEN,"MF,FW",Metz,fr Ligue 1,18,2005,1.4,6,4,2,1,3,2,2,100.0,0,3,0,3,1,7,2,0,Matches
2345,Leroy Sané,de GER,FW,Bayern Munich,de Bundesliga,27,1996,23.7,15,8,6,6,3,4,19,21.1,15,12,0,12,7,22,3,0,Matches
2346,Sadibou Sané,sn SEN,DF,Metz,fr Ligue 1,19,2004,9.4,19,12,16,2,1,6,7,85.7,1,14,9,5,8,27,64,0,Matches
2347,Arouna Sangante,sn SEN,DF,Le Havre,fr Ligue 1,21,2002,29.9,53,33,27,23,3,24,40,60.0,16,35,18,17,66,119,93,2,Matches
2348,Ibrahim Sangaré,ci CIV,MF,Nott'ham Forest,eng Premier League,25,1997,11.5,42,23,25,13,4,12,29,41.4,17,24,7,17,16,58,21,0,Matches
2349,Morgan Sanson,fr FRA,MF,Nice,fr Ligue 1,28,1994,21.8,26,19,12,7,7,12,31,38.7,19,34,5,29,20,46,16,0,Matches
2350,Nicola Sansone,it ITA,"FW,MF",Lecce,it Serie A,31,1991,8.5,11,6,6,2,3,5,16,31.3,11,7,1,6,4,15,5,2,Matches
2351,Baptiste Santamaria,fr FRA,MF,Rennes,fr Ligue 1,28,1995,21.4,52,33,21,25,6,29,46,63.0,17,15,6,9,34,86,33,1,Matches
2352,Yellu Santiago,es ESP,MF,Getafe,es La Liga,19,2004,7.3,17,8,8,5,4,4,7,57.1,3,3,0,3,0,17,8,0,Matches
2353,Andrey Santos,br BRA,MF,Nott'ham Forest,eng Premier League,19,2004,0.1,0,0,0,0,0,0,0,,0,1,0,1,0,0,0,0,Matches
2354,Andrey Santos,br BRA,MF,Strasbourg,fr Ligue 1,19,2004,9.2,29,18,15,13,1,17,26,65.4,9,8,0,8,10,39,11,1,Matches
2355,Tiago Santos,pt POR,DF,Lille,fr Ligue 1,21,2002,26.3,63,42,31,19,13,30,52,57.7,22,24,5,19,15,78,37,0,Matches
2356,Paco Sanz,es ESP,DF,Almería,es La Liga,18,2004,0.3,0,0,0,0,0,0,1,0.0,1,0,0,0,0,0,4,0,Matches
2357,Riccardo Saponara,it ITA,"FW,MF",Hellas Verona,it Serie A,31,1991,3.8,3,1,2,0,1,1,7,14.3,6,4,0,4,0,3,2,0,Matches
2358,Pablo Sarabia,es ESP,"MF,FW",Wolves,eng Premier League,31,1992,19.4,20,13,8,8,4,12,36,33.3,24,17,1,16,10,30,9,0,Matches
2359,Amin Sarr,se SWE,"FW,MF",Lyon,fr Ligue 1,22,2001,1.1,1,0,0,1,0,0,0,,0,1,0,1,0,1,1,0,Matches
2360,Amin Sarr,se SWE,"FW,MF",Wolfsburg,de Bundesliga,22,2001,4.3,3,2,1,2,0,1,2,50.0,1,6,1,5,2,5,1,0,Matches
2361,Bouna Sarr,sn SEN,DF,Bayern Munich,de Bundesliga,31,1992,1.2,2,0,1,1,0,2,2,100.0,0,3,0,3,0,2,1,0,Matches
2362,Ismaila Sarr,sn SEN,"FW,MF",Marseille,fr Ligue 1,25,1998,16.1,14,8,2,10,2,6,17,35.3,11,21,6,15,13,27,11,0,Matches
2363,Mamadou Sarr,fr FRA,DF,Lyon,fr Ligue 1,17,2005,0.1,0,0,0,0,0,0,0,,0,0,0,0,0,0,0,0,Matches
2364,Martin Satriano,uy URU,FW,Brest,fr Ligue 1,22,2001,20.7,24,16,6,13,5,10,25,40.0,15,19,7,12,7,31,28,0,Matches
2365,Téji Savanier,fr FRA,MF,Montpellier,fr Ligue 1,31,1991,30.7,37,20,16,15,6,14,63,22.2,49,36,8,28,33,70,28,1,Matches
2366,Stefan Savić,me MNE,DF,Atlético Madrid,es La Liga,32,1991,18.1,27,19,16,7,4,15,30,50.0,15,29,15,14,27,54,61,1,Matches
2367,Sávio,br BRA,"FW,MF",Girona,es La Liga,19,2004,33.1,42,25,14,22,6,16,28,57.1,12,34,0,34,18,60,11,1,Matches
2368,Zanos Savva,cy CYP,"DF,MF",Torino,it Serie A,17,2005,0.3,1,1,0,1,0,1,3,33.3,2,0,0,0,0,1,1,0,Matches
2369,Saba Sazonov,ge GEO,DF,Torino,it Serie A,21,2002,4.0,9,7,4,5,0,3,3,100.0,0,8,5,3,3,12,22,0,Matches
2370,Joe Scally,us USA,DF,Gladbach,de Bundesliga,20,2002,24.8,41,28,21,17,3,23,40,57.5,17,31,11,20,18,59,78,2,Matches
2371,Giorgio Scalvini,it ITA,DF,Atalanta,it Serie A,19,2003,28.3,53,33,29,19,5,19,40,47.5,21,44,17,27,59,112,71,0,Matches
2372,Gianluca Scamacca,it ITA,FW,Atalanta,it Serie A,24,1999,16.1,15,9,4,5,6,7,14,50.0,7,7,1,6,4,19,9,0,Matches
2373,Dane Scarlett,eng ENG,FW,Tottenham,eng Premier League,19,2004,0.2,1,1,0,0,1,0,1,0.0,1,0,0,0,0,1,0,0,Matches
2374,Kevin Schade,de GER,"FW,MF",Brentford,eng Premier League,21,2001,3.7,3,1,1,2,0,0,5,0.0,5,2,0,2,1,4,4,0,Matches
2375,András Schäfer,hu HUN,MF,Union Berlin,de Bundesliga,24,1999,13.5,29,16,9,15,5,11,20,55.0,9,25,4,21,20,49,25,0,Matches
2376,Fabian Schär,ch SUI,DF,Newcastle Utd,eng Premier League,31,1991,33.9,42,24,27,13,2,18,40,45.0,22,50,38,12,36,78,133,1,Matches
2377,Patrik Schick,cz CZE,FW,Leverkusen,de Bundesliga,27,1996,11.8,6,4,0,3,3,1,5,20.0,4,2,0,2,1,7,7,0,Matches
2378,Stefan Schimmer,de GER,"MF,FW",Heidenheim,de Bundesliga,29,1994,1.7,1,1,0,1,0,0,3,0.0,3,2,0,2,1,2,6,0,Matches
2379,Xaver Schlager,at AUT,MF,RB Leipzig,de Bundesliga,25,1997,27.5,81,50,35,38,8,21,53,39.6,32,41,8,33,19,100,27,0,Matches
2380,Keven Schlotterbeck,de GER,DF,Bochum,de Bundesliga,26,1997,24.3,42,22,26,14,2,25,30,83.3,5,33,23,10,33,75,104,2,Matches
2381,Nico Schlotterbeck,de GER,DF,Dortmund,de Bundesliga,23,1999,31.8,70,50,36,27,7,41,65,63.1,24,52,25,27,45,115,101,3,Matches
2382,Jeffrey Schlupp,gh GHA,"FW,MF",Crystal Palace,eng Premier League,30,1992,15.0,38,24,14,16,8,9,18,50.0,9,13,2,11,8,46,24,0,Matches
2383,Romano Schmid,at AUT,"MF,FW",Werder Bremen,de Bundesliga,23,2000,28.9,35,20,7,22,6,14,46,30.4,32,36,7,29,11,46,17,2,Matches
2384,Kenneth Schmidt,de GER,DF,Freiburg,de Bundesliga,21,2002,0.8,2,2,2,0,0,2,4,50.0,2,1,0,1,1,3,2,0,Matches
2385,Niklas Schmidt,de GER,MF,Toulouse,fr Ligue 1,25,1998,14.1,36,21,13,19,4,16,33,48.5,17,14,7,7,4,40,13,0,Matches
2386,Benno Schmitz,de GER,DF,Köln,de Bundesliga,28,1994,12.8,27,15,20,7,0,17,34,50.0,17,19,4,15,7,34,29,0,Matches
2387,Fabian Schnellhardt,de GER,MF,Darmstadt 98,de Bundesliga,29,1994,2.6,4,1,2,1,1,1,3,33.3,2,1,0,1,4,8,5,0,Matches
2388,Jan Schöppner,de GER,MF,Heidenheim,de Bundesliga,24,1999,22.2,48,26,26,20,2,21,42,50.0,21,37,7,30,26,74,57,0,Matches
2389,Marcel Schuhen,de GER,GK,Darmstadt 98,de Bundesliga,30,1993,31.0,1,0,1,0,0,1,3,33.3,2,0,0,0,2,3,11,4,Matches
2390,Perr Schuurs,nl NED,DF,Torino,it Serie A,23,1999,8.6,20,12,11,8,1,3,9,33.3,6,10,2,8,9,29,23,0,Matches
2391,Marvin Schwäbe,de GER,GK,Köln,de Bundesliga,28,1995,34.0,1,0,1,0,0,1,1,100.0,0,0,0,0,0,1,10,1,Matches
2392,Alexander Schwolow,de GER,GK,Union Berlin,de Bundesliga,31,1992,1.0,0,0,0,0,0,0,0,,0,0,0,0,0,0,2,0,Matches
2393,Alex Scott,eng ENG,MF,Bournemouth,eng Premier League,19,2003,11.3,24,15,8,10,6,12,28,42.9,16,14,4,10,12,36,18,2,Matches
2394,Simone Scuffet,it ITA,GK,Cagliari,it Serie A,27,1996,31.0,1,0,1,0,0,1,2,50.0,1,1,0,1,1,2,9,0,Matches
2395,Jérémy Sebas,mq MTQ,"FW,MF",Strasbourg,fr Ligue 1,20,2003,4.4,7,1,2,3,2,3,5,60.0,2,3,1,2,1,8,1,0,Matches
2396,Demba Seck,sn SEN,MF,Torino,it Serie A,22,2001,4.7,5,3,1,4,0,3,4,75.0,1,1,0,1,1,6,0,0,Matches
2397,Demba Seck,sn SEN,"FW,MF",Frosinone,it Serie A,22,2001,3.3,7,4,2,3,2,4,5,80.0,1,3,0,3,1,8,1,0,Matches
2398,Aleksandar Sedlar,rs SRB,DF,Alavés,es La Liga,31,1991,10.5,14,10,10,4,0,10,16,62.5,6,8,4,4,13,27,43,0,Matches
2399,Alidu Seidu,gh GHA,DF,Rennes,fr Ligue 1,23,2000,6.6,21,9,17,3,1,14,19,73.7,5,11,3,8,10,31,13,0,Matches
2400,Alidu Seidu,gh GHA,DF,Clermont Foot,fr Ligue 1,23,2000,12.6,32,24,17,15,0,24,31,77.4,7,15,7,8,25,57,37,0,Matches
2401,Nicolas Seiwald,at AUT,MF,RB Leipzig,de Bundesliga,22,2001,8.0,33,18,16,15,2,16,25,64.0,9,12,2,10,8,41,15,0,Matches
2402,Nikola Sekulov,it ITA,FW,Juventus,it Serie A,21,2002,0.1,0,0,0,0,0,0,0,,0,0,0,0,0,0,0,0,Matches
2403,Davie Selke,de GER,FW,Köln,de Bundesliga,28,1995,14.1,4,2,1,3,0,0,2,0.0,2,5,3,2,0,4,20,0,Matches
2404,Matz Sels,be BEL,GK,Nott'ham Forest,eng Premier League,31,1992,16.0,0,0,0,0,0,0,0,,0,0,0,0,0,0,11,1,Matches
2405,Matz Sels,be BEL,GK,Strasbourg,fr Ligue 1,31,1992,19.0,0,0,0,0,0,0,0,,0,2,0,2,0,0,13,1,Matches
2406,Nélson Semedo,pt POR,"DF,MF",Wolves,eng Premier League,29,1993,34.3,79,48,52,19,8,38,64,59.4,26,44,8,36,36,115,85,1,Matches
2407,Vivaldo Semedo,pt POR,FW,Udinese,it Serie A,18,2005,0.1,0,0,0,0,0,0,0,,0,0,0,0,0,0,0,0,Matches
2408,Antoine Semenyo,gh GHA,FW,Bournemouth,eng Premier League,23,2000,23.4,24,17,7,9,8,9,27,33.3,18,39,2,37,6,30,21,0,Matches
2409,Marvin Senaya,tg TOG,"DF,MF",Strasbourg,fr Ligue 1,22,2001,23.8,72,53,38,25,9,42,68,61.8,26,40,13,27,41,113,68,0,Matches
2410,Marcos Senesi,ar ARG,DF,Bournemouth,eng Premier League,26,1997,24.9,55,32,28,23,4,24,56,42.9,32,50,23,27,35,90,109,1,Matches
2411,Stefano Sensi,it ITA,MF,Inter,it Serie A,27,1995,0.5,1,1,0,1,0,1,3,33.3,2,1,0,1,1,2,0,0,Matches
2412,Suat Serdar,de GER,MF,Hellas Verona,it Serie A,26,1997,18.4,51,39,24,23,4,22,45,48.9,23,29,7,22,20,71,25,1,Matches
2413,Benjamin Šeško,si SVN,FW,RB Leipzig,de Bundesliga,20,2003,17.0,13,5,2,7,4,2,9,22.2,7,23,2,21,3,16,27,0,Matches
2414,Kevin Sessa,de GER,"MF,FW",Heidenheim,de Bundesliga,23,2000,11.2,17,10,9,6,2,7,16,43.8,9,12,1,11,4,21,17,0,Matches
2415,Aaron Seydel,de GER,FW,Darmstadt 98,de Bundesliga,27,1996,6.9,3,2,0,2,1,0,3,0.0,3,8,2,6,1,4,9,0,Matches
2416,Andres Sfait,ro ROU,"DF,MF",Salernitana,it Serie A,18,2004,0.3,1,1,1,0,0,1,2,50.0,1,0,0,0,0,1,0,0,Matches
2417,Stephan El Shaarawy,it ITA,"FW,DF",Roma,it Serie A,30,1992,19.3,21,13,14,4,3,6,15,40.0,9,11,4,7,13,34,15,2,Matches
2418,Luke Shaw,eng ENG,DF,Manchester Utd,eng Premier League,28,1995,10.7,11,8,7,3,1,9,15,60.0,6,18,11,7,6,17,39,0,Matches
2419,James Shea,eng ENG,GK,Luton Town,eng Premier League,32,1991,0.2,0,0,0,0,0,0,0,,0,0,0,0,0,0,2,0,Matches
2420,Eldor Shomurodov,uz UZB,"FW,MF",Cagliari,it Serie A,28,1995,10.4,11,4,2,6,3,6,10,60.0,4,5,0,5,4,15,4,0,Matches
2421,Steven Shpendi,al ALB,"FW,MF",Empoli,it Serie A,20,2003,4.6,0,0,0,0,0,0,4,0.0,4,2,1,1,1,1,0,0,Matches
2422,Sofiane Sidi Ali,fr FRA,MF,Marseille,fr Ligue 1,28,1995,0.2,2,0,0,2,0,1,2,50.0,1,1,0,1,2,4,0,0,Matches
2423,Vincent Sierro,ch SUI,MF,Toulouse,fr Ligue 1,27,1995,25.1,41,24,15,20,6,27,77,35.1,50,37,13,24,27,68,33,0,Matches
2424,Tim Siersleben,de GER,DF,Heidenheim,de Bundesliga,23,2000,10.1,27,11,21,6,0,8,20,40.0,12,16,10,6,21,48,29,1,Matches
2425,Kiliann Sildillia,fr FRA,DF,Freiburg,de Bundesliga,21,2002,20.1,43,19,28,8,7,26,42,61.9,16,33,15,18,22,65,64,0,Matches
2426,André Silva,pt POR,FW,Real Sociedad,es La Liga,27,1995,8.1,2,2,0,0,2,0,4,0.0,4,3,0,3,1,3,3,0,Matches
2427,Bernardo Silva,pt POR,"MF,FW",Manchester City,eng Premier League,28,1994,28.6,51,23,13,25,13,25,57,43.9,32,32,4,28,17,68,15,1,Matches
2428,Caio Henrique Oliveira Silva,br BRA,DF,Monaco,fr Ligue 1,26,1997,6.9,13,7,3,7,3,6,9,66.7,3,8,2,6,6,19,9,0,Matches
2429,Fábio Silva,pt POR,FW,Wolves,eng Premier League,21,2002,2.9,7,4,3,4,0,2,3,66.7,1,1,0,1,2,9,0,0,Matches
2430,Rui Silva,pt POR,GK,Betis,es La Liga,29,1994,27.5,0,0,0,0,0,0,3,0.0,3,0,0,0,1,1,13,1,Matches
2431,Thiago Silva,br BRA,DF,Chelsea,eng Premier League,38,1984,28.1,29,15,22,6,1,20,34,58.8,14,33,24,9,26,55,153,4,Matches
2432,Marco Silvestri,it ITA,GK,Udinese,it Serie A,32,1991,17.0,0,0,0,0,0,0,3,0.0,3,1,0,1,0,0,5,3,Matches
2433,Mohamed Simakan,fr FRA,DF,RB Leipzig,de Bundesliga,23,2000,23.8,48,29,28,19,1,32,44,72.7,12,36,14,22,29,77,69,0,Matches
2434,Giovanni Simeone,ar ARG,FW,Napoli,it Serie A,28,1995,8.9,12,4,1,3,8,3,12,25.0,9,11,0,11,1,13,7,0,Matches
2435,Giuliano Simeone,ar ARG,FW,Alavés,es La Liga,20,2002,7.0,7,5,2,3,2,5,17,29.4,12,10,0,10,5,12,3,0,Matches
2436,Jan-Carlo Simic,rs SRB,DF,Milan,it Serie A,18,2005,1.6,1,1,1,0,0,0,0,,0,5,4,1,0,1,3,0,Matches
2437,Moses Simon,ng NGA,"FW,MF",Nantes,fr Ligue 1,28,1995,19.9,7,5,2,5,0,2,8,25.0,6,9,1,8,3,10,5,1,Matches
2438,Unai Simón,es ESP,GK,Athletic Club,es La Liga,26,1997,35.4,2,1,1,1,0,2,3,66.7,1,0,0,0,1,3,9,0,Matches
2439,Xavi Simons,nl NED,MF,RB Leipzig,de Bundesliga,20,2003,29.5,30,17,10,11,9,15,31,48.4,16,23,0,23,16,46,4,0,Matches
2440,Wilfried Singo,ci CIV,DF,Monaco,fr Ligue 1,22,2000,24.3,34,25,18,14,2,17,26,65.4,9,27,14,13,51,85,81,2,Matches
2441,Luis Sinisterra,co COL,"FW,MF",Bournemouth,eng Premier League,24,1999,7.8,23,12,9,10,4,9,16,56.3,7,18,0,18,8,31,4,0,Matches
2442,Daley Sinkgraven,nl NED,DF,Las Palmas,es La Liga,28,1995,4.2,11,5,6,5,0,2,8,25.0,6,5,3,2,6,17,9,0,Matches
2443,Jailson Siqueira,br BRA,"DF,MF",Celta Vigo,es La Liga,27,1995,10.0,27,18,22,5,0,13,24,54.2,11,13,5,8,12,39,32,0,Matches
2444,Ayanda Sishuba,be BEL,"MF,FW",Lens,fr Ligue 1,18,2005,0.7,3,1,0,2,1,1,2,50.0,1,1,0,1,0,3,0,0,Matches
2445,Ibrahima Sissoko,ml MLI,MF,Strasbourg,fr Ligue 1,25,1997,18.2,47,33,13,25,9,23,30,76.7,7,21,8,13,19,66,30,0,Matches
2446,Moussa Sissoko,fr FRA,MF,Nantes,fr Ligue 1,33,1989,20.2,27,16,13,8,6,12,25,48.0,13,8,2,6,12,39,31,0,Matches
2447,Antonio Sivera,es ESP,GK,Alavés,es La Liga,26,1996,34.0,0,0,0,0,0,0,1,0.0,1,0,0,0,0,0,17,1,Matches
2448,Tim Skarke,de GER,"FW,DF",Darmstadt 98,de Bundesliga,26,1996,26.7,26,16,12,10,4,10,28,35.7,18,25,2,23,6,32,20,0,Matches
2449,Ellyes Skhiri,tn TUN,MF,Eint Frankfurt,de Bundesliga,28,1995,24.1,44,24,18,19,7,19,36,52.8,17,33,4,29,39,83,47,2,Matches
2450,Oliver Skipp,eng ENG,"MF,DF",Tottenham,eng Premier League,22,2000,7.9,18,12,9,6,3,11,18,61.1,7,12,1,11,3,21,9,0,Matches
2451,Leo Skiri Østigård,no NOR,DF,Napoli,it Serie A,23,1999,18.1,24,12,13,10,1,6,11,54.5,5,18,12,6,16,40,65,0,Matches
2452,Łukasz Skorupski,pl POL,GK,Bologna,it Serie A,32,1991,32.0,2,2,2,0,0,2,3,66.7,1,0,0,0,1,3,11,3,Matches
2453,Robert Skov,dk DEN,"DF,FW",Hoffenheim,de Bundesliga,27,1996,14.0,24,16,15,8,1,17,36,47.2,19,17,4,13,10,34,23,1,Matches
2454,Milan Škriniar,sk SVK,DF,Paris S-G,fr Ligue 1,28,1995,18.1,24,18,17,7,0,14,22,63.6,8,19,10,9,12,36,51,2,Matches
2455,Naatan Skyttä,fi FIN,"MF,FW",Toulouse,fr Ligue 1,21,2002,1.3,4,4,2,1,1,1,1,100.0,0,0,0,0,0,4,0,0,Matches
2456,Chris Smalling,eng ENG,DF,Roma,it Serie A,33,1989,4.3,1,1,1,0,0,1,4,25.0,3,6,5,1,5,6,8,0,Matches
2457,Adam Smith,eng ENG,DF,Bournemouth,eng Premier League,32,1991,23.9,37,23,18,11,8,19,39,48.7,20,28,11,17,21,58,62,0,Matches
2458,Emile Smith Rowe,eng ENG,MF,Arsenal,eng Premier League,23,2000,3.9,4,1,2,2,0,2,4,50.0,2,3,1,2,3,7,1,0,Matches
2459,Hrvoje Smolčić,hr CRO,DF,Eint Frankfurt,de Bundesliga,22,2000,3.9,7,3,7,0,0,4,5,80.0,1,3,1,2,6,13,23,1,Matches
2460,Cédric Soares,pt POR,DF,Arsenal,eng Premier League,31,1991,0.7,0,0,0,0,0,0,0,,0,0,0,0,0,0,0,0,Matches
2461,Danilo Soares,br BRA,DF,Bochum,de Bundesliga,31,1991,3.9,10,6,5,3,2,5,8,62.5,3,6,0,6,7,17,11,0,Matches
2462,Eduard Sobol,ua UKR,DF,Strasbourg,fr Ligue 1,28,1995,0.3,0,0,0,0,0,0,0,,0,0,0,0,0,0,1,0,Matches
2463,Rubén Sobrino,es ESP,"MF,FW",Cádiz,es La Liga,31,1992,18.3,52,28,18,26,8,22,51,43.1,29,26,2,24,16,68,18,0,Matches
2464,Andrea Sodero,it ITA,MF,Empoli,it Serie A,18,2004,0.1,0,0,0,0,0,0,0,,0,0,0,0,0,0,0,0,Matches
2465,Emran Soglo,fr FRA,"MF,DF",Marseille,fr Ligue 1,18,2005,1.2,2,1,0,2,0,1,3,33.3,2,6,0,6,1,3,3,0,Matches
2466,Alex Sola,es ESP,"FW,MF",Alavés,es La Liga,24,1999,14.0,27,15,11,9,7,14,26,53.8,12,18,2,16,11,38,16,0,Matches
2467,Alex Sola,es ESP,"DF,MF",Real Sociedad,es La Liga,24,1999,0.3,0,0,0,0,0,0,0,,0,0,0,0,1,1,2,0,Matches
2468,Dominic Solanke,eng ENG,FW,Bournemouth,eng Premier League,25,1997,36.9,23,11,3,13,7,10,29,34.5,19,24,5,19,7,30,43,0,Matches
2469,Ola Solbakken,no NOR,FW,Roma,it Serie A,24,1998,0.3,0,0,0,0,0,0,0,,0,0,0,0,0,0,0,0,Matches
2470,Carlos Soler,es ESP,"MF,DF",Paris S-G,fr Ligue 1,26,1997,12.1,15,10,9,2,4,6,21,28.6,15,10,3,7,5,20,11,1,Matches
2471,Jhon Solis,co COL,MF,Girona,es La Liga,18,2004,4.3,10,8,4,5,1,4,12,33.3,8,8,3,5,8,18,7,1,Matches
2472,Manor Solomon,il ISR,FW,Tottenham,eng Premier League,24,1999,2.2,3,3,1,1,1,1,2,50.0,1,4,0,4,3,6,2,0,Matches
2473,Daniele Sommariva,it ITA,GK,Genoa,it Serie A,26,1997,0.1,0,0,0,0,0,0,0,,0,0,0,0,0,0,0,0,Matches
2474,Yann Sommer,ch SUI,GK,Inter,it Serie A,34,1988,34.0,2,1,2,0,0,2,2,100.0,0,1,0,1,0,2,7,1,Matches
2475,Brandon Soppy,fr FRA,DF,Torino,it Serie A,21,2002,2.0,2,2,1,1,0,2,6,33.3,4,2,0,2,0,2,3,1,Matches
2476,David Soria,es ESP,GK,Getafe,es La Liga,30,1993,37.9,0,0,0,0,0,0,2,0.0,2,0,0,0,0,0,21,6,Matches
2477,Alberto Soro,es ESP,MF,Granada,es La Liga,24,1999,0.1,0,0,0,0,0,0,0,,0,0,0,0,0,0,0,0,Matches
2478,Alessandro Sorrentino,it ITA,GK,Monza,it Serie A,21,2002,6.1,0,0,0,0,0,0,0,,0,0,0,0,0,0,0,0,Matches
2479,Borna Sosa,hr CRO,"FW,DF",Stuttgart,de Bundesliga,25,1998,0.5,0,0,0,0,0,0,1,0.0,1,0,0,0,0,0,0,0,Matches
2480,Hugo Sotelo,es ESP,MF,Celta Vigo,es La Liga,19,2003,8.0,19,17,3,13,3,8,20,40.0,12,7,1,6,2,21,5,0,Matches
2481,Florian Sotoca,fr FRA,"MF,FW",Lens,fr Ligue 1,32,1990,28.9,33,22,9,21,3,17,38,44.7,21,41,4,37,20,53,34,0,Matches
2482,Riccardo Sottil,it ITA,FW,Fiorentina,it Serie A,24,1999,12.3,10,5,5,1,4,3,8,37.5,5,12,0,12,2,12,2,0,Matches
2483,Tomáš Souček,cz CZE,MF,West Ham,eng Premier League,28,1995,31.9,53,35,24,26,3,21,47,44.7,26,55,28,27,37,90,109,0,Matches
2484,Matìas Soulé,ar ARG,"FW,MF",Frosinone,it Serie A,20,2003,34.7,41,27,12,14,15,19,40,47.5,21,38,4,34,18,59,9,0,Matches
2485,Boubakary Soumaré,fr FRA,MF,Sevilla,es La Liga,24,1999,25.4,39,28,24,14,1,14,26,53.8,12,25,7,18,26,65,20,1,Matches
2486,Issa Soumaré,sn SEN,"FW,MF",Le Havre,fr Ligue 1,22,2000,2.6,2,0,2,0,0,0,4,0.0,4,0,0,0,0,2,2,0,Matches
2487,Vinicius Souza,br BRA,MF,Sheffield Utd,eng Premier League,24,1999,29.6,125,76,59,51,15,41,74,55.4,33,57,17,40,32,157,75,1,Matches
2488,Djibril Sow,ch SUI,MF,Sevilla,es La Liga,26,1997,16.2,28,21,15,8,5,9,25,36.0,16,20,3,17,17,45,8,1,Matches
2489,Saidou Sow,gn GUI,DF,Strasbourg,fr Ligue 1,21,2002,8.0,20,12,17,3,0,9,13,69.2,4,7,4,3,12,32,36,3,Matches
2490,Çağlar Söyüncü,tr TUR,DF,Atlético Madrid,es La Liga,27,1996,1.3,1,1,1,0,0,0,0,,0,1,0,1,1,2,7,0,Matches
2491,Djed Spence,eng ENG,DF,Genoa,it Serie A,22,2000,9.5,16,10,12,4,0,8,10,80.0,2,20,5,15,8,24,28,0,Matches
2492,Stijn Spierings,nl NED,MF,Toulouse,fr Ligue 1,27,1996,16.8,53,40,26,20,7,29,52,55.8,23,22,5,17,26,79,32,0,Matches
2493,Stijn Spierings,nl NED,MF,Lens,fr Ligue 1,27,1996,1.3,1,0,0,1,0,1,1,100.0,0,2,1,1,2,3,1,0,Matches
2494,Leonardo Spinazzola,it ITA,DF,Roma,it Serie A,30,1993,14.6,15,7,10,5,0,8,18,44.4,10,8,2,6,3,18,15,0,Matches
2495,Marco Sportiello,it ITA,GK,Milan,it Serie A,31,1992,7.0,0,0,0,0,0,0,0,,0,0,0,0,0,0,2,0,Matches
2496,Anton Stach,de GER,MF,Hoffenheim,de Bundesliga,24,1998,25.8,73,42,40,27,6,33,63,52.4,30,38,12,26,72,145,67,1,Matches
2497,Anton Stach,de GER,MF,Mainz 05,de Bundesliga,24,1998,1.9,3,0,2,0,1,2,4,50.0,2,5,0,5,2,5,5,0,Matches
2498,Jens Stage,dk DEN,MF,Werder Bremen,de Bundesliga,26,1996,25.9,52,22,21,23,8,18,50,36.0,32,42,23,19,23,75,55,0,Matches
2499,Benjamin Stambouli,fr FRA,MF,Reims,fr Ligue 1,32,1990,3.2,9,7,3,5,1,6,11,54.5,5,3,1,2,2,11,8,0,Matches
2500,Josip Stanišić,hr CRO,DF,Leverkusen,de Bundesliga,23,2000,14.0,38,20,19,13,6,22,33,66.7,11,18,3,15,9,47,26,0,Matches
2501,Carl Starfelt,se SWE,DF,Celta Vigo,es La Liga,28,1995,24.6,36,30,30,5,1,19,28,67.9,9,35,28,7,34,70,159,2,Matches
2502,Niklas Stark,de GER,DF,Werder Bremen,de Bundesliga,28,1995,12.1,26,15,13,11,2,12,18,66.7,6,14,7,7,19,45,61,1,Matches
2503,Jason Steele,eng ENG,GK,Brighton,eng Premier League,32,1990,17.0,0,0,0,0,0,0,3,0.0,3,0,0,0,0,0,8,1,Matches
2504,Pascal Stenzel,de GER,DF,Stuttgart,de Bundesliga,27,1996,11.8,18,8,7,9,2,10,30,33.3,20,22,8,14,15,33,26,0,Matches
2505,Leonidas Stergiou,ch SUI,DF,Stuttgart,de Bundesliga,21,2002,6.6,15,8,7,7,1,9,13,69.2,4,8,1,7,5,20,13,0,Matches
2506,Raheem Sterling,eng ENG,"FW,MF",Chelsea,eng Premier League,28,1994,22.0,21,10,7,8,6,12,26,46.2,14,13,0,13,13,34,9,1,Matches
2507,Trivante Stewart,jm JAM,"FW,MF",Salernitana,it Serie A,23,2000,1.1,0,0,0,0,0,0,0,,0,1,0,1,0,0,0,0,Matches
2508,Angelo Stiller,de GER,MF,Hoffenheim,de Bundesliga,22,2001,0.9,0,0,0,0,0,0,1,0.0,1,2,0,2,0,0,3,0,Matches
2509,Angelo Stiller,de GER,MF,Stuttgart,de Bundesliga,22,2001,29.9,55,33,15,34,6,24,42,57.1,18,41,13,28,28,83,25,2,Matches
2510,Kevin Stöger,at AUT,MF,Bochum,de Bundesliga,29,1993,29.6,49,30,21,21,7,25,63,39.7,38,46,4,42,19,68,18,0,Matches
2511,Filip Stojilković,ch SUI,"FW,MF",Darmstadt 98,de Bundesliga,23,2000,1.7,1,1,0,0,1,0,0,,0,0,0,0,0,1,1,0,Matches
2512,John Stones,eng ENG,"DF,MF",Manchester City,eng Premier League,29,1994,11.8,2,1,1,0,1,0,3,0.0,3,11,7,4,10,12,21,0,Matches
2513,Thomas Strakosha,al ALB,GK,Brentford,eng Premier League,28,1995,1.5,0,0,0,0,0,0,0,,0,0,0,0,0,0,0,0,Matches
2514,Jørgen Strand Larsen,no NOR,FW,Celta Vigo,es La Liga,23,2000,31.8,21,11,1,15,5,8,38,21.1,30,15,1,14,5,26,17,0,Matches
2515,Gabriel Strefezza,br BRA,FW,Lecce,it Serie A,26,1997,12.4,24,17,8,7,9,14,20,70.0,6,17,0,17,7,31,11,0,Matches
2516,Kevin Strootman,nl NED,MF,Genoa,it Serie A,33,1990,13.4,34,19,13,18,3,15,31,48.4,16,20,6,14,7,41,22,0,Matches
2517,Cristhian Stuani,uy URU,FW,Girona,es La Liga,36,1986,8.9,14,11,4,6,4,4,7,57.1,3,9,2,7,5,19,13,0,Matches
2518,Álex Suárez,es ESP,DF,Las Palmas,es La Liga,30,1993,28.5,53,36,33,15,5,31,37,83.8,6,33,14,19,18,71,84,0,Matches
2519,Damián Suárez,uy URU,DF,Getafe,es La Liga,35,1988,14.4,36,21,16,16,4,26,45,57.8,19,13,3,10,10,46,31,0,Matches
2520,Denis Suárez,es ESP,"MF,FW",Villarreal,es La Liga,29,1994,1.5,0,0,0,0,0,0,2,0.0,2,2,2,0,0,0,4,0,Matches
2521,Gabriel Suazo,cl CHI,DF,Toulouse,fr Ligue 1,25,1997,26.2,66,32,40,19,7,38,86,44.2,48,37,4,33,26,92,33,0,Matches
2522,Isaac Success,ng NGA,"FW,MF",Udinese,it Serie A,27,1996,9.8,6,4,0,5,1,1,3,33.3,2,6,1,5,2,8,11,0,Matches
2523,Niklas Süle,de GER,DF,Dortmund,de Bundesliga,27,1995,16.8,18,10,14,3,1,11,16,68.8,5,25,14,11,25,43,58,2,Matches
2524,Ibrahim Sulemana,gh GHA,MF,Cagliari,it Serie A,20,2003,14.9,36,14,15,15,6,17,27,63.0,10,24,5,19,7,43,23,0,Matches
2525,Tomáš Suslov,sk SVK,"MF,FW",Hellas Verona,it Serie A,21,2002,23.2,42,30,11,22,9,15,47,31.9,32,15,0,15,6,48,8,0,Matches
2526,Suso,es ESP,"MF,FW",Sevilla,es La Liga,29,1993,16.9,24,17,14,8,2,8,28,28.6,20,9,0,9,5,29,4,0,Matches
2527,Mattias Svanberg,se SWE,MF,Wolfsburg,de Bundesliga,24,1999,19.1,37,17,8,19,10,12,38,31.6,26,25,5,20,21,58,28,0,Matches
2528,Max Svensson,es ESP,FW,Osasuna,es La Liga,,,0.0,1,0,0,0,1,0,0,,0,0,0,0,0,1,0,0,Matches
2529,Mile Svilar,rs SRB,GK,Roma,it Serie A,23,1999,15.0,0,0,0,0,0,0,0,,0,0,0,0,0,0,2,1,Matches
2530,Williot Swedberg,se SWE,"FW,MF",Celta Vigo,es La Liga,19,2004,4.9,9,4,3,6,0,5,8,62.5,3,11,1,10,0,9,4,0,Matches
2531,Karol Świderski,pl POL,"FW,MF",Hellas Verona,it Serie A,26,1997,5.6,7,3,1,3,3,2,3,66.7,1,6,4,2,1,8,8,0,Matches
2532,Abakar Sylla,ci CIV,DF,Strasbourg,fr Ligue 1,20,2002,19.9,54,23,30,19,5,29,40,72.5,11,40,11,29,26,80,70,2,Matches
2533,Dembo Sylla,gn GUI,DF,Lorient,fr Ligue 1,20,2002,0.5,1,1,0,1,0,0,0,,0,0,0,0,1,2,2,0,Matches
2534,Issiaga Sylla,gn GUI,"DF,FW",Montpellier,fr Ligue 1,29,1994,16.2,28,17,20,6,2,16,34,47.1,18,21,7,14,23,51,53,0,Matches
2535,Mamadou Sylla,sn SEN,"FW,MF",Alavés,es La Liga,29,1994,0.2,0,0,0,0,0,0,0,,0,1,1,0,0,0,1,0,Matches
2536,Attila Szalai,hu HUN,DF,Hoffenheim,de Bundesliga,25,1998,3.2,3,1,3,0,0,1,4,25.0,3,6,2,4,1,4,7,0,Matches
2537,Attila Szalai,hu HUN,DF,Freiburg,de Bundesliga,25,1998,1.1,1,1,1,0,0,1,2,50.0,1,5,2,3,1,2,11,1,Matches
2538,Wojciech Szczęsny,pl POL,GK,Juventus,it Serie A,33,1990,35.0,0,0,0,0,0,0,0,,0,0,0,0,1,1,11,2,Matches
2539,Dominik Szoboszlai,hu HUN,MF,Liverpool,eng Premier League,22,2000,23.4,32,19,12,12,8,16,50,32.0,34,37,2,35,15,47,16,1,Matches
2540,Przemysław Szymiński,pl POL,MF,Frosinone,it Serie A,29,1994,0.1,0,0,0,0,0,0,0,,0,1,1,0,0,0,0,0,Matches
2541,Alexander Sørloth,no NOR,FW,Villarreal,es La Liga,27,1995,27.7,6,3,1,2,3,2,6,33.3,4,9,4,5,0,6,26,0,Matches
2542,Musa Al-Taamari,jo JOR,FW,Montpellier,fr Ligue 1,26,1997,21.4,20,16,10,5,5,9,21,42.9,12,18,2,16,4,24,5,0,Matches
2543,Nicolás Tagliafico,ar ARG,DF,Lyon,fr Ligue 1,30,1992,23.6,54,34,23,22,9,22,49,44.9,27,25,8,17,28,82,43,0,Matches
2544,Jonathan Tah,de GER,DF,Leverkusen,de Bundesliga,27,1996,29.2,19,9,10,7,2,5,16,31.3,11,28,23,5,23,42,97,1,Matches
2545,Montassar Talbi,tn TUN,DF,Lorient,fr Ligue 1,25,1998,24.5,38,22,23,13,2,19,32,59.4,13,39,23,16,32,70,114,0,Matches
2546,Yassin Tallal,es ESP,FW,Getafe,es La Liga,18,2005,0.0,0,0,0,0,0,0,0,,0,0,0,0,0,0,0,0,Matches
2547,Adrien Tameze,cm CMR,"DF,MF",Torino,it Serie A,29,1994,23.8,35,16,13,18,4,18,37,48.6,19,24,11,13,47,82,25,2,Matches
2548,Renato Tapia,pe PER,"MF,DF",Celta Vigo,es La Liga,28,1995,14.9,41,29,19,19,3,14,25,56.0,11,31,7,24,21,62,50,1,Matches
2549,Edmond Tapsoba,bf BFA,DF,Leverkusen,de Bundesliga,24,1999,23.2,34,25,17,15,2,17,24,70.8,7,21,10,11,24,58,52,3,Matches
2550,Matt Targett,eng ENG,DF,Newcastle Utd,eng Premier League,27,1995,0.9,2,0,1,1,0,1,1,100.0,0,1,0,1,0,2,2,0,Matches
2551,Oussama Targhalline,ma MAR,MF,Le Havre,fr Ligue 1,21,2002,11.4,23,11,16,7,0,15,25,60.0,10,9,3,6,20,43,14,2,Matches
2552,James Tarkowski,eng ENG,DF,Everton,eng Premier League,30,1992,38.0,61,42,46,14,1,27,48,56.3,21,82,56,26,56,117,191,2,Matches
2553,César Tárrega,es ESP,DF,Valencia,es La Liga,21,2002,0.1,0,0,0,0,0,0,0,,0,0,0,0,0,0,2,0,Matches
2554,Jimi Tauriainen,eng ENG,FW,Chelsea,eng Premier League,19,2004,0.0,0,0,0,0,0,0,0,,0,0,0,0,0,0,0,0,Matches
2555,Nuno Tavares,pt POR,DF,Nott'ham Forest,eng Premier League,23,2000,5.1,11,7,9,1,1,8,9,88.9,1,6,0,6,1,12,21,0,Matches
2556,Marcus Tavernier,eng ENG,FW,Bournemouth,eng Premier League,24,1999,23.5,53,34,25,22,6,26,48,54.2,22,31,3,28,5,58,23,0,Matches
2557,Elayis Tavsan,nl NED,"MF,FW",Hellas Verona,it Serie A,22,2001,0.6,0,0,0,0,0,0,1,0.0,1,0,0,0,0,0,1,0,Matches
2558,Charlie Taylor,eng ENG,DF,Burnley,eng Premier League,29,1993,25.9,35,20,19,14,2,17,35,48.6,18,27,11,16,19,54,78,0,Matches
2559,Marciano Tchami,gw GNB,"FW,MF",Almería,es La Liga,19,2004,0.5,0,0,0,0,0,0,0,,0,0,0,0,0,0,0,0,Matches
2560,Loum Tchaouna,fr FRA,"FW,MF",Salernitana,it Serie A,19,2003,23.3,20,10,5,13,2,10,20,50.0,10,20,1,19,4,24,16,1,Matches
2561,Jackson Tchatchoua,cm CMR,DF,Hellas Verona,it Serie A,21,2001,19.2,39,26,25,12,2,23,48,47.9,25,17,7,10,23,62,49,2,Matches
2562,Enzo Tchato,cm CMR,DF,Montpellier,fr Ligue 1,20,2002,12.5,26,17,18,4,4,11,25,44.0,14,20,7,13,11,37,25,0,Matches
2563,Aurélien Tchouaméni,fr FRA,"MF,DF",Real Madrid,es La Liga,23,2000,22.1,38,23,19,17,2,9,18,50.0,9,21,13,8,28,66,52,1,Matches
2564,Mathys Tel,fr FRA,"FW,MF",Bayern Munich,de Bundesliga,18,2005,11.7,12,2,3,4,5,4,6,66.7,2,11,0,11,6,18,6,0,Matches
2565,Nathan Tella,ng NGA,"DF,MF",Leverkusen,de Bundesliga,24,1999,9.1,13,8,6,5,2,5,10,50.0,5,10,0,10,3,16,8,0,Matches
2566,Nahuel Tenaglia,ar ARG,DF,Alavés,es La Liga,27,1996,12.7,29,19,22,4,3,16,28,57.1,12,14,8,6,12,41,59,0,Matches
2567,Arnau Tenas,es ESP,GK,Paris S-G,fr Ligue 1,22,2001,5.9,0,0,0,0,0,0,0,,0,0,0,0,0,0,0,0,Matches
2568,Marc-André ter Stegen,de GER,GK,Barcelona,es La Liga,31,1992,28.0,0,0,0,0,0,0,0,,0,0,0,0,0,0,3,3,Matches
2569,Filippo Terracciano,it ITA,DF,Hellas Verona,it Serie A,20,2003,14.4,30,19,23,6,1,17,31,54.8,14,24,6,18,20,50,17,0,Matches
2570,Filippo Terracciano,it ITA,"DF,FW",Milan,it Serie A,20,2003,0.8,2,2,1,1,0,1,3,33.3,2,3,0,3,0,2,1,0,Matches
2571,Pietro Terracciano,it ITA,GK,Fiorentina,it Serie A,33,1990,33.0,1,1,1,0,0,1,3,33.3,2,1,0,1,0,1,8,0,Matches
2572,Ramón Terrats,es ESP,"MF,DF",Villarreal,es La Liga,22,2000,8.7,17,13,8,8,1,7,15,46.7,8,11,1,10,3,20,9,0,Matches
2573,Martin Terrier,fr FRA,"FW,MF",Rennes,fr Ligue 1,26,1997,17.0,14,9,3,8,3,6,14,42.9,8,21,4,17,9,23,17,0,Matches
2574,Kenny Tete,nl NED,DF,Fulham,eng Premier League,27,1995,9.6,27,17,19,6,2,11,19,57.9,8,10,3,7,16,43,35,0,Matches
2575,Benjamin Tetteh,gh GHA,"FW,MF",Metz,fr Ligue 1,26,1997,3.1,6,6,1,5,0,4,7,57.1,3,0,0,0,0,6,1,0,Matches
2576,Teddy Teuma,mt MLT,MF,Reims,fr Ligue 1,29,1993,23.5,54,36,19,21,14,25,62,40.3,37,33,4,29,20,74,6,0,Matches
2577,Florian Thauvin,fr FRA,FW,Udinese,it Serie A,30,1993,19.0,7,4,2,4,1,4,13,30.8,9,9,1,8,3,10,2,0,Matches
2578,Arthur Theate,be BEL,DF,Rennes,fr Ligue 1,23,2000,25.5,30,17,19,6,5,24,37,64.9,13,40,23,17,31,61,90,2,Matches
2579,Norman Theuerkauf,de GER,"MF,DF",Heidenheim,de Bundesliga,36,1987,14.0,24,16,13,7,4,13,22,59.1,9,16,6,10,14,38,21,0,Matches
2580,Malick Thiaw,de GER,DF,Milan,it Serie A,21,2001,18.0,34,17,15,17,2,12,25,48.0,13,23,13,10,13,47,55,0,Matches
2581,Jan Thielmann,de GER,"FW,DF",Köln,de Bundesliga,21,2002,17.5,28,18,13,9,6,12,24,50.0,12,31,6,25,8,36,28,0,Matches
2582,Denis Thomalla,de GER,"MF,FW",Heidenheim,de Bundesliga,30,1992,5.0,9,6,4,4,1,5,11,45.5,6,3,2,1,4,13,13,0,Matches
2583,Luke Thomas,eng ENG,DF,Sheffield Utd,eng Premier League,22,2001,10.2,20,9,13,6,1,8,14,57.1,6,23,5,18,10,30,27,0,Matches
2584,Adrien Thomasson,fr FRA,MF,Lens,fr Ligue 1,29,1993,13.3,25,14,4,16,5,11,34,32.4,23,14,0,14,9,34,10,1,Matches
2585,Morten Thorsby,no NOR,MF,Genoa,it Serie A,27,1996,12.9,19,11,9,8,2,7,14,50.0,7,21,5,16,4,23,20,0,Matches
2586,Kristian Thorstvedt,no NOR,MF,Sassuolo,it Serie A,24,1999,26.6,40,22,7,28,5,22,44,50.0,22,25,9,16,21,61,36,0,Matches
2587,Khéphren Thuram,fr FRA,MF,Nice,fr Ligue 1,22,2001,23.4,42,29,13,23,6,20,40,50.0,20,21,10,11,18,60,37,0,Matches
2588,Marcus Thuram,fr FRA,FW,Inter,it Serie A,25,1997,29.9,23,15,9,9,5,4,13,30.8,9,26,3,23,4,27,19,0,Matches
2589,Cheikh Tidiane Sabaly,sn SEN,"FW,MF",Metz,fr Ligue 1,24,1999,15.3,40,20,23,12,5,16,40,40.0,24,19,2,17,10,50,14,0,Matches
2590,Youri Tielemans,be BEL,"MF,FW",Aston Villa,eng Premier League,26,1997,18.0,41,20,17,18,6,16,40,40.0,24,23,3,20,15,56,9,0,Matches
2591,Kieran Tierney,sct SCO,DF,Real Sociedad,es La Liga,26,1997,13.8,37,24,16,18,3,18,27,66.7,9,22,8,14,10,47,45,0,Matches
2592,Phillip Tietz,de GER,FW,Augsburg,de Bundesliga,26,1997,26.5,23,14,7,13,3,6,15,40.0,9,17,3,14,6,29,35,0,Matches
2593,Steffen Tigges,de GER,FW,Köln,de Bundesliga,25,1998,8.1,10,6,4,5,1,3,7,42.9,4,4,2,2,1,11,12,0,Matches
2594,Antonio Tikvić,hr CRO,DF,Udinese,it Serie A,19,2004,0.0,0,0,0,0,0,0,0,,0,0,0,0,0,0,0,0,Matches
2595,Jurriën Timber,nl NED,DF,Arsenal,eng Premier League,22,2001,0.8,2,2,1,1,0,0,0,,0,1,0,1,0,2,1,0,Matches
2596,Jean-Clair Todibo,fr FRA,DF,Nice,fr Ligue 1,23,1999,29.5,58,28,35,17,6,34,56,60.7,22,34,15,19,38,96,97,1,Matches
2597,Harry Toffolo,eng ENG,DF,Nott'ham Forest,eng Premier League,27,1995,16.2,26,14,20,6,0,15,24,62.5,9,34,13,21,14,40,49,0,Matches
2598,Umut Tohumcu,de GER,MF,Hoffenheim,de Bundesliga,18,2004,11.2,16,12,9,7,0,6,19,31.6,13,11,1,10,6,22,12,0,Matches
2599,Corentin Tolisso,fr FRA,MF,Lyon,fr Ligue 1,28,1994,19.3,33,21,13,11,9,14,33,42.4,19,26,9,17,10,43,18,0,Matches
2600,Jeremy Toljan,de GER,DF,Sassuolo,it Serie A,28,1994,23.1,13,10,8,4,1,9,15,60.0,6,17,5,12,16,29,49,1,Matches
2601,Rafael Tolói,it ITA,DF,Atalanta,it Serie A,32,1990,10.7,20,9,7,8,5,14,27,51.9,13,9,4,5,13,33,29,0,Matches
2602,Raúl de Tomás,es ESP,FW,Rayo Vallecano,es La Liga,28,1994,14.1,9,5,4,3,2,3,6,50.0,3,3,0,3,1,10,8,0,Matches
2603,Tiago Tomás,pt POR,"FW,MF",Wolfsburg,de Bundesliga,21,2002,11.5,5,2,3,0,2,1,6,16.7,5,13,0,13,3,8,9,0,Matches
2604,Takehiro Tomiyasu,jp JPN,DF,Arsenal,eng Premier League,24,1998,12.8,20,9,15,4,1,11,18,61.1,7,10,4,6,18,38,33,0,Matches
2605,James Tomkins,eng ENG,DF,Crystal Palace,eng Premier League,34,1989,0.1,0,0,0,0,0,0,0,,0,0,0,0,1,1,0,0,Matches
2606,Fikayo Tomori,eng ENG,DF,Milan,it Serie A,25,1997,23.6,42,24,29,10,3,18,29,62.1,11,34,23,11,26,68,75,1,Matches
2607,Sandro Tonali,it ITA,MF,Newcastle Utd,eng Premier League,23,2000,4.9,7,7,4,2,1,3,9,33.3,6,3,0,3,2,9,4,0,Matches
2608,Ivan Toney,eng ENG,FW,Brentford,eng Premier League,27,1996,16.1,15,5,2,7,6,6,14,42.9,8,5,1,4,10,25,18,0,Matches
2609,Pablo Torre,es ESP,"MF,FW",Girona,es La Liga,20,2003,7.8,5,2,0,5,0,4,10,40.0,6,10,2,8,4,9,6,1,Matches
2610,Raúl Torrente,es ESP,DF,Granada,es La Liga,21,2001,13.9,29,16,20,9,0,17,22,77.3,5,16,10,6,11,40,68,2,Matches
2611,Ferrán Torres,es ESP,FW,Barcelona,es La Liga,23,2000,13.5,9,6,1,6,2,5,16,31.3,11,7,1,6,5,14,6,0,Matches
2612,Óliver Torres,es ESP,MF,Sevilla,es La Liga,28,1994,18.0,37,22,17,15,5,22,57,38.6,35,40,4,36,6,43,6,0,Matches
2613,Pau Torres,es ESP,DF,Aston Villa,eng Premier League,26,1997,27.4,29,18,17,11,1,14,30,46.7,16,28,12,16,14,43,75,0,Matches
2614,Lucas Torró,es ESP,MF,Osasuna,es La Liga,29,1994,19.9,25,15,11,8,6,11,28,39.3,17,10,2,8,33,58,37,0,Matches
2615,Fabio Torsiello,it ITA,"FW,DF",Darmstadt 98,de Bundesliga,18,2005,1.7,1,0,1,0,0,1,8,12.5,7,1,0,1,1,2,1,0,Matches
2616,Ahmed Touba,dz ALG,DF,Lecce,it Serie A,25,1998,3.1,6,4,3,3,0,3,4,75.0,1,4,3,1,7,13,20,0,Matches
2617,Abdoulaye Touré,gn GUI,MF,Le Havre,fr Ligue 1,29,1994,25.4,47,28,22,22,3,30,60,50.0,30,30,8,22,25,72,33,0,Matches
2618,Souleymane Touré,fr FRA,DF,Lorient,fr Ligue 1,20,2003,22.8,25,12,16,9,0,8,14,57.1,6,38,20,18,36,61,101,2,Matches
2619,Lucas Tousart,fr FRA,MF,Union Berlin,de Bundesliga,26,1997,17.5,35,20,14,17,4,17,37,45.9,20,32,9,23,25,60,41,0,Matches
2620,Andros Townsend,eng ENG,"MF,FW",Luton Town,eng Premier League,32,1991,13.4,21,13,11,2,8,13,27,48.1,14,12,0,12,5,26,10,0,Matches
2621,James Trafford,eng ENG,GK,Burnley,eng Premier League,20,2002,28.0,2,1,2,0,0,2,2,100.0,0,0,0,0,1,3,18,1,Matches
2622,Adama Traoré,es ESP,"FW,MF",Fulham,eng Premier League,27,1996,4.2,4,3,1,2,1,3,6,50.0,3,2,0,2,1,5,2,0,Matches
2623,Bénie Traoré,ci CIV,"FW,MF",Sheffield Utd,eng Premier League,20,2002,4.3,4,2,1,2,1,0,4,0.0,4,4,1,3,1,5,1,0,Matches
2624,Bénie Traoré,ci CIV,"FW,MF",Nantes,fr Ligue 1,20,2002,5.6,8,4,2,5,1,3,7,42.9,4,3,0,3,1,9,1,0,Matches
2625,Bertrand Traoré,bf BFA,"DF,FW",Aston Villa,eng Premier League,27,1995,0.1,1,1,1,0,0,0,0,,0,0,0,0,0,1,1,0,Matches
2626,Bertrand Traoré,bf BFA,MF,Villarreal,es La Liga,27,1995,6.3,5,4,2,1,2,1,4,25.0,3,6,0,6,1,6,2,0,Matches
2627,Boubacar Traoré,ml MLI,MF,Wolves,eng Premier League,21,2001,9.1,35,23,16,17,2,9,21,42.9,12,12,2,10,5,40,7,0,Matches
2628,Chaka Traorè,ci CIV,FW,Milan,it Serie A,18,2004,0.2,2,1,2,0,0,1,2,50.0,1,1,1,0,0,2,0,0,Matches
2629,Daouda Traoré,fr FRA,MF,Nice,fr Ligue 1,17,2006,0.2,0,0,0,0,0,0,0,,0,0,0,0,0,0,0,0,Matches
2630,Hamari Traoré,ml MLI,DF,Real Sociedad,es La Liga,31,1992,25.5,44,19,24,17,3,25,43,58.1,18,27,8,19,24,68,59,2,Matches
2631,Ismaël Traoré,ci CIV,DF,Metz,fr Ligue 1,36,1986,24.7,19,12,13,6,0,8,21,38.1,13,33,20,13,30,49,86,0,Matches
2632,Omar Traoré,de GER,DF,Heidenheim,de Bundesliga,25,1998,27.5,60,33,33,21,6,32,56,57.1,24,32,7,25,40,100,54,1,Matches
2633,Kevin Trapp,de GER,GK,Eint Frankfurt,de Bundesliga,33,1990,32.0,0,0,0,0,0,0,0,,0,0,0,0,1,1,9,1,Matches
2634,Mark Travers,ie IRL,GK,Bournemouth,eng Premier League,24,1999,4.0,0,0,0,0,0,0,0,,0,0,0,0,0,0,2,0,Matches
2635,Óscar Trejo,ar ARG,"FW,MF",Rayo Vallecano,es La Liga,35,1988,15.3,27,15,11,9,7,13,21,61.9,8,21,1,20,5,32,9,0,Matches
2636,Mike Trésor,be BEL,"FW,MF",Burnley,eng Premier League,24,1999,4.7,10,6,9,1,0,8,18,44.4,10,5,0,5,1,11,1,0,Matches
2637,Manu Trigueros,es ESP,MF,Villarreal,es La Liga,31,1991,3.4,7,5,6,1,0,4,10,40.0,6,1,1,0,3,10,9,0,Matches
2638,Christopher Trimmel,at AUT,DF,Union Berlin,de Bundesliga,36,1987,18.3,23,15,12,10,1,13,33,39.4,20,16,3,13,13,36,57,0,Matches
2639,Kieran Trippier,eng ENG,DF,Newcastle Utd,eng Premier League,32,1990,24.8,57,27,30,16,11,37,77,48.1,40,41,8,33,24,81,57,3,Matches
2640,Leandro Trossard,be BEL,"FW,MF",Arsenal,eng Premier League,28,1994,18.3,27,16,8,9,10,9,25,36.0,16,27,1,26,8,35,6,0,Matches
2641,Adrien Truffert,fr FRA,DF,Rennes,fr Ligue 1,21,2001,23.8,39,21,23,10,6,25,40,62.5,15,31,5,26,19,58,49,0,Matches
2642,Auston Trusty,us USA,DF,Sheffield Utd,eng Premier League,24,1998,28.6,47,30,31,13,3,21,43,48.8,22,41,22,19,35,82,153,3,Matches
2643,Kostas Tsimikas,gr GRE,DF,Liverpool,eng Premier League,27,1996,7.5,19,13,9,6,4,9,15,60.0,6,9,1,8,6,25,10,0,Matches
2644,Viktor Tsyhankov,ua UKR,"MF,FW",Girona,es La Liga,25,1997,22.8,29,20,11,13,5,14,26,53.8,12,18,1,17,12,41,24,0,Matches
2645,Stefano Turati,it ITA,GK,Frosinone,it Serie A,21,2001,30.5,0,0,0,0,0,0,0,,0,0,0,0,0,0,6,3,Matches
2646,Matt Turner,us USA,GK,Nott'ham Forest,eng Premier League,29,1994,17.0,0,0,0,0,0,0,0,,0,0,0,0,0,0,8,4,Matches
2647,Beñat Turrientes,es ESP,MF,Real Sociedad,es La Liga,21,2002,18.7,31,17,6,20,5,13,30,43.3,17,19,8,11,6,37,17,0,Matches
2648,Tuta,br BRA,DF,Eint Frankfurt,de Bundesliga,24,1999,28.9,63,33,38,19,6,39,59,66.1,20,29,12,17,36,99,99,0,Matches
2649,Destiny Udogie,it ITA,DF,Tottenham,eng Premier League,20,2002,26.6,68,33,41,16,11,27,49,55.1,22,27,8,19,37,105,80,5,Matches
2650,Matthieu Udol,fr FRA,DF,Metz,fr Ligue 1,27,1996,30.0,55,37,38,12,5,38,56,67.9,18,62,16,46,50,105,108,0,Matches
2651,Manuel Ugarte,uy URU,MF,Paris S-G,fr Ligue 1,22,2001,21.5,98,57,39,43,16,43,89,48.3,46,27,6,21,40,138,25,2,Matches
2652,Lesley Ugochukwu,fr FRA,MF,Chelsea,eng Premier League,19,2004,3.3,14,10,4,8,2,4,10,40.0,6,6,2,4,1,15,5,0,Matches
2653,Lukas Ullrich,de GER,"DF,FW",Gladbach,de Bundesliga,19,2004,0.5,1,0,1,0,0,1,4,25.0,3,0,0,0,0,1,1,0,Matches
2654,Sven Ulreich,de GER,GK,Bayern Munich,de Bundesliga,34,1988,11.0,1,0,1,0,0,1,1,100.0,0,0,0,0,0,1,3,2,Matches
2655,Samuel Umtiti,fr FRA,DF,Lille,fr Ligue 1,29,1993,2.1,1,1,0,1,0,1,4,25.0,3,0,0,0,2,3,4,0,Matches
2656,Enes Ünal,tr TUR,"FW,MF",Bournemouth,eng Premier League,26,1997,3.6,6,4,2,3,1,2,5,40.0,3,4,2,2,1,7,6,0,Matches
2657,Enes Ünal,tr TUR,"FW,MF",Getafe,es La Liga,26,1997,1.6,0,0,0,0,0,0,0,,0,1,0,1,0,0,2,0,Matches
2658,Deniz Undav,de GER,"FW,MF",Stuttgart,de Bundesliga,27,1996,23.2,28,13,6,8,14,4,15,26.7,11,17,0,17,6,34,5,0,Matches
2659,Dayot Upamecano,fr FRA,DF,Bayern Munich,de Bundesliga,24,1998,19.6,34,21,21,11,2,15,29,51.7,14,19,7,12,19,53,56,3,Matches
2660,Kacper Urbanski,pl POL,"MF,FW",Bologna,it Serie A,18,2004,10.3,16,10,5,10,1,6,13,46.2,7,15,1,14,4,20,14,0,Matches
2661,Mark Uth,de GER,"MF,FW",Köln,de Bundesliga,31,1991,4.1,8,4,2,3,3,4,12,33.3,8,6,0,6,1,9,2,0,Matches
2662,Myrto Uzuni,al ALB,FW,Granada,es La Liga,28,1995,27.2,18,14,8,7,3,6,27,22.2,21,19,3,16,4,22,7,0,Matches
2663,Josha Vagnoman,de GER,DF,Stuttgart,de Bundesliga,22,2000,13.1,28,18,15,11,2,15,30,50.0,15,11,5,6,2,30,16,1,Matches
2664,Óscar Valentín,es ESP,MF,Rayo Vallecano,es La Liga,28,1994,29.9,107,66,39,62,6,46,101,45.5,55,62,10,52,35,142,52,1,Matches
2665,Emanuele Valeri,it ITA,DF,Frosinone,it Serie A,24,1998,13.1,19,16,10,5,4,10,21,47.6,11,14,3,11,9,28,22,0,Matches
2666,Martin Valjent,sk SVK,DF,Mallorca,es La Liga,27,1995,26.1,34,18,19,13,2,18,30,60.0,12,26,11,15,29,63,112,1,Matches
2667,Jesús Vallejo,es ESP,DF,Granada,es La Liga,26,1997,1.2,3,1,1,2,0,2,2,100.0,0,3,2,1,0,3,1,1,Matches
2668,Álvaro Vallés,es ESP,GK,Las Palmas,es La Liga,26,1997,36.3,3,2,3,0,0,3,8,37.5,5,0,0,0,0,3,40,1,Matches
2669,Federico Valverde,uy URU,MF,Real Madrid,es La Liga,25,1998,32.3,47,34,22,13,12,24,42,57.1,18,39,2,37,43,90,40,0,Matches
2670,Kévin Van Den Kerkhof,dz ALG,"FW,MF",Metz,fr Ligue 1,27,1996,21.3,31,24,11,13,7,13,32,40.6,19,15,2,13,11,42,32,1,Matches
2671,Siebe Van Der Heyden,be BEL,DF,Mallorca,es La Liga,25,1998,3.2,9,2,7,2,0,4,6,66.7,2,1,1,0,7,16,12,0,Matches
2672,Virgil van Dijk,nl NED,DF,Liverpool,eng Premier League,32,1991,35.3,40,23,24,13,3,12,14,85.7,2,47,34,13,39,79,144,0,Matches
2673,Vanderson,br BRA,DF,Monaco,fr Ligue 1,22,2001,18.2,60,41,20,30,10,32,70,45.7,38,29,2,27,35,95,37,1,Matches
2674,Raphaël Varane,fr FRA,DF,Manchester Utd,eng Premier League,30,1993,15.3,18,11,10,7,1,10,14,71.4,4,23,18,5,15,33,88,0,Matches
2675,Ruben Vargas,ch SUI,"MF,FW",Augsburg,de Bundesliga,24,1998,21.8,23,10,6,10,7,10,25,40.0,15,19,4,15,7,30,17,0,Matches
2676,Johan Vásquez,mx MEX,DF,Genoa,it Serie A,24,1998,31.7,51,33,38,11,2,32,50,64.0,18,50,26,24,45,96,113,0,Matches
2677,José Luis García Vayá,es ESP,MF,Valencia,es La Liga,24,1998,36.7,78,53,36,36,6,37,71,52.1,34,41,10,31,49,127,71,0,Matches
2678,Borja Vázquez,es ESP,FW,Cádiz,es La Liga,18,2005,0.0,1,0,1,0,0,1,1,100.0,0,0,0,0,0,1,1,0,Matches
2679,Jesus Vazquez,es ESP,"DF,MF",Valencia,es La Liga,20,2003,8.0,24,12,13,8,3,10,16,62.5,6,17,4,13,3,27,24,0,Matches
2680,Kevin Vázquez,es ESP,DF,Celta Vigo,es La Liga,30,1993,7.8,15,13,7,7,1,12,21,57.1,9,11,3,8,5,20,25,0,Matches
2681,Lucas Vázquez,es ESP,DF,Real Madrid,es La Liga,32,1991,15.8,37,25,22,14,1,18,25,72.0,7,27,5,22,12,49,36,0,Matches
2682,Matías Vecino,uy URU,MF,Lazio,it Serie A,31,1991,12.8,32,17,12,20,0,20,31,64.5,11,17,5,12,12,44,21,0,Matches
2683,Gabriel Veiga,es ESP,FW,Celta Vigo,es La Liga,21,2002,0.2,0,0,0,0,0,0,0,,0,0,0,0,0,0,0,0,Matches
2684,Alejo Véliz,ar ARG,FW,Tottenham,eng Premier League,19,2003,0.6,1,0,1,0,0,0,0,,0,0,0,0,0,1,0,0,Matches
2685,Alejo Véliz,ar ARG,FW,Sevilla,es La Liga,19,2003,0.4,1,0,0,1,0,1,2,50.0,1,0,0,0,0,1,1,0,Matches
2686,Miloš Veljković,rs SRB,DF,Werder Bremen,de Bundesliga,27,1995,21.3,31,15,17,13,1,16,31,51.6,15,31,20,11,17,48,57,0,Matches
2687,Joël Veltman,nl NED,DF,Brighton,eng Premier League,31,1992,17.6,54,41,32,17,5,39,58,67.2,19,17,7,10,18,72,57,1,Matches
2688,Micky van de Ven,nl NED,DF,Tottenham,eng Premier League,22,2001,26.0,49,35,34,12,3,24,33,72.7,9,25,15,10,18,67,78,1,Matches
2689,Lorenzo Venuti,it ITA,DF,Lecce,it Serie A,28,1995,4.0,6,4,5,1,0,6,10,60.0,4,4,3,1,5,11,14,0,Matches
2690,Bart Verbruggen,nl NED,GK,Brighton,eng Premier League,20,2002,21.0,1,1,1,0,0,1,2,50.0,1,0,0,0,0,1,11,3,Matches
2691,Simone Verdi,it ITA,FW,Torino,it Serie A,31,1992,0.0,0,0,0,0,0,0,0,,0,0,0,0,0,0,0,0,Matches
2692,Jordan Veretout,fr FRA,MF,Marseille,fr Ligue 1,30,1993,24.3,38,22,19,13,6,18,39,46.2,21,20,4,16,13,51,25,0,Matches
2693,Arthur Vermeeren,be BEL,MF,Atlético Madrid,es La Liga,18,2005,1.8,1,0,0,1,0,0,1,0.0,1,5,0,5,6,7,2,0,Matches
2694,Yorbe Vertessen,be BEL,"FW,MF",Union Berlin,de Bundesliga,22,2001,6.6,3,2,0,3,0,1,4,25.0,3,8,0,8,1,4,3,0,Matches
2695,Mikel Vesga,es ESP,MF,Athletic Club,es La Liga,30,1993,17.0,40,20,11,23,6,19,49,38.8,30,19,7,12,32,72,35,1,Matches
2696,Guglielmo Vicario,it ITA,GK,Tottenham,eng Premier League,26,1996,38.0,0,0,0,0,0,0,1,0.0,1,0,0,0,1,1,31,2,Matches
2697,Carlos Vicente,es ESP,FW,Alavés,es La Liga,24,1999,12.4,16,6,7,7,2,10,25,40.0,15,4,0,4,4,20,9,0,Matches
2698,Nacho Vidal,es ESP,"DF,FW",Osasuna,es La Liga,28,1995,1.1,5,4,2,2,1,2,5,40.0,3,2,0,2,0,5,6,0,Matches
2699,Nacho Vidal,es ESP,DF,Mallorca,es La Liga,28,1995,4.6,12,5,4,5,3,6,13,46.2,7,5,2,3,3,15,9,0,Matches
2700,Fabio Vieira,pt POR,"MF,FW",Arsenal,eng Premier League,23,2000,3.3,3,2,2,0,1,3,3,100.0,0,0,0,0,2,5,2,0,Matches
2701,Fran Vieites,es ESP,GK,Betis,es La Liga,24,1999,3.5,1,0,1,0,0,1,1,100.0,0,0,0,0,0,1,2,1,Matches
2702,Jonathan Viera,es ESP,"MF,FW",Las Palmas,es La Liga,33,1989,6.9,6,3,1,2,3,1,9,11.1,8,0,0,0,0,6,1,0,Matches
2703,Jonathan Viera,es ESP,MF,Almería,es La Liga,33,1989,10.1,19,9,6,9,4,10,19,52.6,9,4,0,4,4,23,1,0,Matches
2704,Emanuel Vignato,it ITA,"MF,FW",Salernitana,it Serie A,22,2000,3.5,10,7,4,5,1,5,6,83.3,1,1,0,1,1,11,7,0,Matches
2705,Samuele Vignato,it ITA,"MF,FW",Monza,it Serie A,19,2004,3.8,6,4,2,3,1,2,3,66.7,1,2,0,2,1,7,1,0,Matches
2706,Oscar Vilhelmsson,se SWE,"FW,MF",Darmstadt 98,de Bundesliga,19,2003,15.3,13,6,3,7,3,7,10,70.0,3,15,5,10,3,16,19,0,Matches
2707,Toni Villa,es ESP,FW,Girona,es La Liga,28,1995,0.1,0,0,0,0,0,0,0,,0,0,0,0,0,0,0,0,Matches
2708,Asier Villalibre,es ESP,FW,Athletic Club,es La Liga,25,1997,5.7,2,1,0,0,2,2,2,100.0,0,2,1,1,0,2,6,0,Matches
2709,Gonzalo Villar,es ESP,MF,Granada,es La Liga,25,1998,20.0,51,33,26,20,5,26,41,63.4,15,32,10,22,6,57,26,1,Matches
2710,Iván Villar,es ESP,GK,Celta Vigo,es La Liga,26,1997,11.3,0,0,0,0,0,0,1,0.0,1,0,0,0,0,0,6,0,Matches
2711,Matías Viña,uy URU,DF,Sassuolo,it Serie A,25,1997,11.3,34,21,22,7,5,20,36,55.6,16,12,2,10,9,43,34,0,Matches
2712,Rúben Vinagre,pt POR,"DF,FW",Hellas Verona,it Serie A,24,1999,3.1,4,2,1,1,2,3,4,75.0,1,6,3,3,1,5,4,0,Matches
2713,Carlos Vinícius,br BRA,FW,Fulham,eng Premier League,28,1995,3.5,3,2,0,1,2,0,4,0.0,4,4,0,4,0,3,1,0,Matches
2714,Nicolas Viola,it ITA,"MF,FW",Cagliari,it Serie A,33,1989,13.4,13,9,2,8,3,7,17,41.2,10,9,0,9,2,15,6,0,Matches
2715,Alan Virginius,fr FRA,FW,Lille,fr Ligue 1,20,2003,0.8,1,1,1,0,0,0,1,0.0,1,0,0,0,0,1,0,0,Matches
2716,Alan Virginius,fr FRA,FW,Clermont Foot,fr Ligue 1,20,2003,10.4,9,5,4,4,1,4,11,36.4,7,7,0,7,3,12,7,0,Matches
2717,Ricardo Visus,es ESP,DF,Betis,es La Liga,22,2001,1.8,2,2,1,1,0,2,2,100.0,0,2,2,0,2,4,9,1,Matches
2718,Mattia Viti,it ITA,DF,Sassuolo,it Serie A,21,2002,10.9,24,15,14,7,3,10,22,45.5,12,20,10,10,10,34,44,0,Matches
2719,Vitinha,pt POR,"FW,MF",Genoa,it Serie A,23,2000,3.2,2,2,1,0,1,1,2,50.0,1,2,0,2,0,2,2,0,Matches
2720,Vitinha,pt POR,FW,Marseille,fr Ligue 1,23,2000,10.3,14,8,3,5,6,3,12,25.0,9,11,2,9,5,19,8,0,Matches
2721,Vitinha,pt POR,MF,Paris S-G,fr Ligue 1,23,2000,23.6,39,24,12,16,11,16,48,33.3,32,29,11,18,23,62,30,2,Matches
2722,Vitinho,br BRA,"DF,MF",Burnley,eng Premier League,24,1999,25.7,64,34,36,22,6,43,86,50.0,43,44,6,38,12,76,47,4,Matches
2723,Daniel Vivian,es ESP,DF,Athletic Club,es La Liga,24,1999,32.0,42,28,29,11,2,28,45,62.2,17,49,25,24,31,73,104,0,Matches
2724,Odysseas Vlachodimos,gr GRE,GK,Nott'ham Forest,eng Premier League,29,1994,5.0,0,0,0,0,0,0,1,0.0,1,0,0,0,0,0,1,0,Matches
2725,Dušan Vlahović,rs SRB,FW,Juventus,it Serie A,23,2000,25.6,9,5,0,6,3,4,11,36.4,7,4,2,2,1,10,11,0,Matches
2726,Nikola Vlašić,hr CRO,"MF,FW",Torino,it Serie A,25,1997,29.0,28,16,6,14,8,4,30,13.3,26,26,7,19,11,39,16,0,Matches
2727,Alessandro Vogliacco,it ITA,DF,Genoa,it Serie A,24,1998,13.0,23,15,14,8,1,12,15,80.0,3,16,10,6,30,53,40,1,Matches
2728,Kevin Vogt,de GER,DF,Hoffenheim,de Bundesliga,31,1991,14.7,14,10,7,7,0,8,13,61.5,5,16,13,3,9,23,54,0,Matches
2729,Kevin Vogt,de GER,DF,Union Berlin,de Bundesliga,31,1991,14.7,10,9,6,4,0,6,12,50.0,6,22,15,7,7,17,72,2,Matches
2730,Mërgim Vojvoda,xk KVX,DF,Torino,it Serie A,28,1995,15.3,17,8,7,6,4,11,16,68.8,5,12,2,10,13,30,28,0,Matches
2731,Kevin Volland,de GER,"FW,MF",Union Berlin,de Bundesliga,31,1992,14.9,22,9,8,8,6,8,20,40.0,12,8,0,8,6,28,12,0,Matches
2732,Cristian Volpato,it ITA,"MF,FW",Sassuolo,it Serie A,19,2003,7.2,16,8,9,6,1,9,25,36.0,16,7,0,7,1,17,5,0,Matches
2733,Aster Vranckx,be BEL,MF,Wolfsburg,de Bundesliga,20,2002,12.8,32,15,11,11,10,15,28,53.6,13,17,6,11,14,46,29,0,Matches
2734,Stefan de Vrij,nl NED,DF,Inter,it Serie A,31,1992,17.6,18,13,13,4,1,8,15,53.3,7,22,10,12,24,42,51,0,Matches
2735,Elye Wahi,fr FRA,FW,Montpellier,fr Ligue 1,20,2003,0.2,0,0,0,0,0,0,0,,0,0,0,0,0,0,0,0,Matches
2736,Elye Wahi,fr FRA,FW,Lens,fr Ligue 1,20,2003,18.8,6,4,1,3,2,2,10,20.0,8,5,1,4,3,9,3,0,Matches
2737,Walace,br BRA,MF,Udinese,it Serie A,28,1995,36.0,66,43,40,26,0,36,77,46.8,41,43,6,37,43,109,66,1,Matches
2738,Luca Waldschmidt,de GER,"MF,FW",Köln,de Bundesliga,27,1996,12.7,19,12,4,12,3,5,16,31.3,11,18,3,15,6,25,8,1,Matches
2739,Kyle Walker,eng ENG,DF,Manchester City,eng Premier League,33,1990,30.7,38,24,19,17,2,19,39,48.7,20,19,6,13,27,65,40,1,Matches
2740,Sebastian Walukiewicz,pl POL,DF,Empoli,it Serie A,23,2000,22.8,39,28,33,6,0,28,41,68.3,13,50,31,19,15,54,121,0,Matches
2741,Aaron Wan-Bissaka,cd COD,DF,Manchester Utd,eng Premier League,25,1997,19.8,42,25,18,20,4,19,26,73.1,7,29,15,14,41,83,68,1,Matches
2742,Joel Ward,eng ENG,DF,Crystal Palace,eng Premier League,33,1989,22.0,45,28,26,18,1,30,47,63.8,17,17,10,7,14,59,94,1,Matches
2743,James Ward-Prowse,eng ENG,MF,West Ham,eng Premier League,28,1994,33.3,45,29,14,23,8,18,44,40.9,26,31,9,22,38,83,49,0,Matches
2744,Lewis Warrington,eng ENG,FW,Everton,eng Premier League,20,2002,0.0,0,0,0,0,0,0,0,,0,0,0,0,0,0,0,0,Matches
2745,Deivid Washington,br BRA,"DF,FW",Chelsea,eng Premier League,18,2005,0.1,1,1,1,0,0,0,1,0.0,1,0,0,0,0,1,0,0,Matches
2746,Kjell-Arik Wätjen,de GER,"MF,FW",Dortmund,de Bundesliga,17,2006,1.2,3,2,2,1,0,2,5,40.0,3,1,1,0,0,3,3,0,Matches
2747,Ollie Watkins,eng ENG,FW,Aston Villa,eng Premier League,27,1995,35.7,12,7,0,5,7,5,11,45.5,6,26,4,22,4,16,20,0,Matches
2748,Timothy Weah,us USA,"DF,FW",Juventus,it Serie A,23,2000,14.0,27,20,16,8,3,15,20,75.0,5,12,1,11,5,32,15,0,Matches
2749,Adam Webster,eng ENG,DF,Brighton,eng Premier League,28,1995,12.7,14,12,8,5,1,6,18,33.3,12,16,12,4,16,30,43,1,Matches
2750,Wout Weghorst,nl NED,FW,Hoffenheim,de Bundesliga,30,1992,22.0,13,6,4,7,2,9,15,60.0,6,25,8,17,6,19,24,0,Matches
2751,Julian Weigl,de GER,MF,Gladbach,de Bundesliga,27,1995,30.7,66,40,28,32,6,41,67,61.2,26,47,14,33,48,114,61,1,Matches
2752,Nelson Weiper,de GER,"FW,MF",Mainz 05,de Bundesliga,18,2005,1.4,2,1,2,0,0,2,3,66.7,1,1,0,1,1,3,0,0,Matches
2753,Mitchell Weiser,de GER,"DF,MF",Werder Bremen,de Bundesliga,29,1994,29.3,64,38,29,25,10,31,53,58.5,22,36,6,30,20,84,43,0,Matches
2754,Noah Weißhaupt,de GER,"DF,FW",Freiburg,de Bundesliga,21,2001,8.4,9,4,6,0,3,5,11,45.5,6,8,1,7,8,17,12,0,Matches
2755,Shon Weissman,il ISR,"FW,DF",Salernitana,it Serie A,27,1996,5.5,4,3,2,0,2,0,4,0.0,4,2,1,1,3,7,4,0,Matches
2756,Shon Weissman,il ISR,FW,Granada,es La Liga,27,1996,0.9,1,1,0,0,1,1,4,25.0,3,3,0,3,0,1,1,0,Matches
2757,Danny Welbeck,eng ENG,"FW,MF",Brighton,eng Premier League,32,1990,18.8,35,17,9,17,9,10,17,58.8,7,12,0,12,9,44,17,1,Matches
2758,Timo Werner,de GER,FW,Tottenham,eng Premier League,27,1996,9.0,7,4,3,4,0,5,18,27.8,13,12,0,12,3,10,2,0,Matches
2759,Timo Werner,de GER,"FW,MF",RB Leipzig,de Bundesliga,27,1996,2.3,2,1,0,1,1,0,0,,0,1,0,1,1,3,0,0,Matches
2760,Adam Wharton,eng ENG,MF,Crystal Palace,eng Premier League,19,2004,14.4,48,32,18,22,8,23,46,50.0,23,17,3,14,20,68,24,1,Matches
2761,Ethan Wheatley,eng ENG,FW,Manchester Utd,eng Premier League,17,2006,0.2,1,1,0,1,0,1,1,100.0,0,2,0,2,2,3,0,0,Matches
2762,Ben White,eng ENG,DF,Arsenal,eng Premier League,25,1997,33.2,48,28,20,22,6,26,58,44.8,32,48,22,26,32,80,77,1,Matches
2763,Joe White,eng ENG,MF,Newcastle Utd,eng Premier League,20,2002,0.1,1,1,1,0,0,0,0,,0,0,0,0,0,1,0,0,Matches
2764,Silvan Widmer,ch SUI,DF,Mainz 05,de Bundesliga,30,1993,13.8,23,10,12,8,3,17,28,60.7,11,18,5,13,16,39,37,0,Matches
2765,Mateusz Wieteska,pl POL,DF,Cagliari,it Serie A,26,1997,10.7,14,11,9,3,2,3,10,30.0,7,10,5,5,14,28,48,0,Matches
2766,Mateusz Wieteska,pl POL,DF,Clermont Foot,fr Ligue 1,26,1997,1.9,4,1,3,1,0,3,5,60.0,2,4,2,2,5,9,8,0,Matches
2767,Iñaki Williams,gh GHA,FW,Athletic Club,es La Liga,29,1994,31.6,24,17,6,8,10,13,34,38.2,21,42,8,34,14,38,29,0,Matches
2768,Neco Williams,wls WAL,DF,Nott'ham Forest,eng Premier League,22,2001,18.2,69,40,42,18,9,35,56,62.5,21,44,13,31,22,91,53,0,Matches
2769,Nico Williams,es ESP,FW,Athletic Club,es La Liga,21,2002,25.1,31,12,9,15,7,13,36,36.1,23,18,2,16,3,34,4,1,Matches
2770,Willian,br BRA,FW,Fulham,eng Premier League,34,1988,22.8,18,11,6,7,5,3,21,14.3,18,13,0,13,9,27,12,1,Matches
2771,Joe Willock,eng ENG,MF,Newcastle Utd,eng Premier League,23,1999,4.7,13,7,7,6,0,4,11,36.4,7,7,0,7,1,14,1,0,Matches
2772,Callum Wilson,eng ENG,FW,Newcastle Utd,eng Premier League,31,1992,11.0,5,3,0,2,3,0,4,0.0,4,6,0,6,2,7,4,0,Matches
2773,Harry Wilson,wls WAL,FW,Fulham,eng Premier League,26,1997,18.0,21,14,9,8,4,11,28,39.3,17,27,3,24,10,31,12,0,Matches
2774,Josh Wilson-Esbrand,eng ENG,"DF,MF",Reims,fr Ligue 1,20,2002,5.1,5,4,2,3,0,2,8,25.0,6,5,2,3,6,11,7,0,Matches
2775,Patrick Wimmer,at AUT,"FW,MF",Wolfsburg,de Bundesliga,22,2001,6.5,14,5,5,5,4,8,18,44.4,10,14,0,14,3,17,7,0,Matches
2776,Jonas Wind,dk DEN,FW,Wolfsburg,de Bundesliga,24,1999,29.5,13,10,4,6,3,7,17,41.2,10,13,4,9,3,16,21,0,Matches
2777,Florian Wirtz,de GER,MF,Leverkusen,de Bundesliga,20,2003,26.4,27,18,7,14,6,9,29,31.0,20,36,2,34,9,36,3,0,Matches
2778,Yoane Wissa,cd COD,FW,Brentford,eng Premier League,26,1996,27.7,28,16,13,10,5,5,20,25.0,15,24,3,21,9,37,15,0,Matches
2779,Axel Witsel,be BEL,DF,Atlético Madrid,es La Liga,34,1989,30.9,35,21,23,12,0,17,24,70.8,7,40,21,19,16,51,119,0,Matches
2780,Maximilian Wittek,de GER,"DF,FW",Bochum,de Bundesliga,27,1995,11.9,23,17,9,11,3,13,21,61.9,8,12,1,11,18,41,23,0,Matches
2781,Maximilian Wöber,at AUT,DF,Gladbach,de Bundesliga,25,1998,23.0,66,31,40,25,1,31,53,58.5,22,47,26,21,38,104,111,0,Matches
2782,Marius Wolf,de GER,DF,Dortmund,de Bundesliga,28,1995,13.0,20,12,8,11,1,11,23,47.8,12,12,2,10,8,28,20,0,Matches
2783,Nick Woltemade,de GER,"FW,MF",Werder Bremen,de Bundesliga,21,2002,13.2,34,23,7,20,7,15,21,71.4,6,12,0,12,5,39,17,0,Matches
2784,Jeong Woo-yeong,kr KOR,"MF,FW",Stuttgart,de Bundesliga,23,1999,7.0,15,9,6,8,1,6,8,75.0,2,5,0,5,7,22,5,0,Matches
2785,Chris Wood,nz NZL,FW,Nott'ham Forest,eng Premier League,31,1991,20.1,7,4,1,4,2,3,9,33.3,6,11,3,8,1,8,26,0,Matches
2786,Cauley Woodrow,eng ENG,"FW,MF",Luton Town,eng Premier League,28,1994,4.7,16,10,8,4,4,9,16,56.3,7,7,1,6,1,17,14,0,Matches
2787,Christopher Wooh,cm CMR,DF,Rennes,fr Ligue 1,21,2001,15.4,18,12,12,6,0,8,15,53.3,7,19,9,10,18,36,51,0,Matches
2788,Joe Worrall,eng ENG,DF,Nott'ham Forest,eng Premier League,26,1997,4.9,7,5,6,1,0,3,6,50.0,3,5,4,1,3,10,32,1,Matches
2789,Xeber,es ESP,"FW,MF",Alavés,es La Liga,26,1997,3.4,5,5,3,2,0,3,7,42.9,4,2,1,1,1,6,2,0,Matches
2790,Granit Xhaka,ch SUI,MF,Leverkusen,de Bundesliga,30,1992,31.3,29,21,11,14,4,9,30,30.0,21,29,8,21,19,48,42,0,Matches
2791,Antal Yaakobishvili,hu HUN,DF,Girona,es La Liga,19,2004,0.7,2,1,1,1,0,1,1,100.0,0,0,0,0,3,5,3,0,Matches
2792,Lamine Yamal,es ESP,FW,Barcelona,es La Liga,16,2007,24.5,61,37,32,15,14,18,48,37.5,30,32,0,32,19,80,11,0,Matches
2793,Roman Yaremchuk,ua UKR,FW,Valencia,es La Liga,27,1995,10.3,5,2,1,2,2,3,6,50.0,3,4,0,4,1,6,9,0,Matches
2794,Yehor Yarmoliuk,ua UKR,MF,Brentford,eng Premier League,19,2004,7.6,17,11,6,8,3,7,17,41.2,10,17,4,13,6,23,5,0,Matches
2795,Ryan Yates,eng ENG,MF,Nott'ham Forest,eng Premier League,25,1997,22.1,66,40,39,21,6,20,36,55.6,16,42,15,27,21,87,44,1,Matches
2796,Yusuf Yazıcı,tr TUR,"MF,FW",Lille,fr Ligue 1,26,1997,14.6,19,11,6,9,4,4,15,26.7,11,10,1,9,5,24,5,0,Matches
2797,Kelvin Yeboah,it ITA,FW,Montpellier,fr Ligue 1,23,2000,3.1,4,2,2,2,0,1,3,33.3,2,3,2,1,1,5,3,0,Matches
2798,Bertuğ Yıldırım,tr TUR,FW,Rennes,fr Ligue 1,21,2002,5.2,7,5,2,3,2,3,8,37.5,5,8,0,8,0,7,4,0,Matches
2799,Kenan Yıldız,tr TUR,"FW,MF",Juventus,it Serie A,18,2005,10.6,13,9,5,6,2,4,8,50.0,4,6,0,6,1,14,4,0,Matches
2800,Darlin Yongwa,cm CMR,DF,Lorient,fr Ligue 1,22,2000,12.9,30,23,17,11,2,14,25,56.0,11,14,2,12,15,45,36,0,Matches
2801,Leny Yoro,fr FRA,DF,Lille,fr Ligue 1,17,2005,29.7,36,25,27,7,2,17,31,54.8,14,20,14,6,36,72,97,1,Matches
2802,Ashley Young,eng ENG,"DF,MF",Everton,eng Premier League,38,1985,25.3,53,38,28,19,6,30,54,55.6,24,24,6,18,22,75,50,3,Matches
2803,Etienne Youte Kinkoue,fr FRA,DF,Le Havre,fr Ligue 1,21,2002,21.6,15,9,13,2,0,7,11,63.6,4,21,16,5,44,59,104,0,Matches
2804,Illia Zabarnyi,ua UKR,DF,Bournemouth,eng Premier League,20,2002,37.0,59,32,29,29,1,23,50,46.0,27,53,34,19,33,92,143,4,Matches
2805,Mattia Zaccagni,it ITA,"FW,MF",Lazio,it Serie A,28,1995,21.7,27,16,11,15,1,9,21,42.9,12,26,2,24,21,48,15,0,Matches
2806,Dan-Axel Zagadou,fr FRA,DF,Stuttgart,de Bundesliga,24,1999,16.1,21,14,16,5,0,4,8,50.0,4,23,18,5,20,41,78,1,Matches
2807,Yoram Zague,fr FRA,DF,Paris S-G,fr Ligue 1,17,2006,4.1,18,8,11,4,3,11,24,45.8,13,3,0,3,4,22,9,1,Matches
2808,Warren Zaïre-Emery,fr FRA,"MF,DF",Paris S-G,fr Ligue 1,17,2006,21.8,51,28,18,24,9,28,51,54.9,23,32,8,24,15,66,22,2,Matches
2809,Denis Zakaria,ch SUI,"MF,DF",Monaco,fr Ligue 1,26,1996,23.7,38,27,11,20,7,12,30,40.0,18,39,13,26,47,85,41,0,Matches
2810,Arsen Zakharyan,ru RUS,"MF,FW",Real Sociedad,es La Liga,20,2003,13.6,22,15,8,11,3,9,22,40.9,13,16,0,16,4,26,10,0,Matches
2811,Joseba Zaldúa,es ESP,DF,Cádiz,es La Liga,31,1992,7.8,20,12,17,2,1,13,21,61.9,8,6,4,2,2,22,20,0,Matches
2812,Nicola Zalewski,pl POL,"DF,FW",Roma,it Serie A,21,2002,10.8,20,14,10,9,1,8,22,36.4,14,12,4,8,9,29,17,0,Matches
2813,Andre-Frank Zambo Anguissa,cm CMR,MF,Napoli,it Serie A,27,1995,31.0,61,33,21,29,11,34,69,49.3,35,40,5,35,28,89,19,1,Matches
2814,Nicolò Zaniolo,it ITA,"FW,MF",Aston Villa,eng Premier League,24,1999,9.3,19,9,10,7,2,9,17,52.9,8,13,0,13,1,20,11,0,Matches
2815,Alessandro Zanoli,it ITA,DF,Salernitana,it Serie A,22,2000,10.2,16,13,9,7,0,7,12,58.3,5,10,2,8,1,17,17,0,Matches
2816,Alessandro Zanoli,it ITA,"DF,FW",Napoli,it Serie A,22,2000,0.6,1,1,1,0,0,0,0,,0,0,0,0,1,2,1,0,Matches
2817,Duván Zapata,co COL,FW,Torino,it Serie A,32,1991,32.0,18,7,9,2,7,3,12,25.0,9,20,6,14,7,25,26,0,Matches
2818,Duván Zapata,co COL,FW,Atalanta,it Serie A,32,1991,1.2,0,0,0,0,0,0,1,0.0,1,0,0,0,0,0,1,0,Matches
2819,Gabriele Zappa,it ITA,DF,Cagliari,it Serie A,23,1999,28.5,54,31,29,16,9,29,41,70.7,12,29,5,24,20,74,75,2,Matches
2820,Davide Zappacosta,it ITA,DF,Atalanta,it Serie A,31,1992,20.7,30,20,15,10,5,16,34,47.1,18,29,4,25,5,35,19,0,Matches
2821,Bryan Zaragoza,es ESP,"MF,FW",Granada,es La Liga,21,2001,18.2,18,9,8,6,4,8,23,34.8,15,9,0,9,3,21,3,0,Matches
2822,Bryan Zaragoza,es ESP,"FW,MF",Bayern Munich,de Bundesliga,21,2001,2.0,4,4,2,1,1,3,3,100.0,0,0,0,0,2,6,0,0,Matches
2823,Anass Zaroury,ma MAR,"FW,MF",Burnley,eng Premier League,22,2000,1.7,1,0,1,0,0,0,4,0.0,4,2,0,2,0,1,1,1,Matches
2824,Oier Zarraga,es ESP,MF,Udinese,it Serie A,24,1999,4.5,3,3,2,1,0,1,5,20.0,4,5,2,3,5,8,16,1,Matches
2825,Mehdi Zeffane,dz ALG,"DF,MF",Clermont Foot,fr Ligue 1,31,1992,13.7,31,20,17,11,3,17,34,50.0,17,14,3,11,16,47,34,0,Matches
2826,Jordan Zemura,zw ZIM,DF,Udinese,it Serie A,23,1999,11.5,24,16,13,7,4,11,19,57.9,8,5,1,4,13,37,21,0,Matches
2827,Robin Zentner,de GER,GK,Mainz 05,de Bundesliga,28,1994,30.0,2,2,2,0,0,2,5,40.0,3,1,0,1,1,3,19,1,Matches
2828,Alessio Zerbin,it ITA,"DF,FW",Monza,it Serie A,24,1999,7.6,18,10,13,2,3,4,13,30.8,9,16,3,13,3,21,5,0,Matches
2829,Alessio Zerbin,it ITA,"FW,DF",Napoli,it Serie A,24,1999,1.7,5,2,1,3,1,2,7,28.6,5,1,0,1,0,5,0,0,Matches
2830,Kevin Zeroli,it ITA,MF,Milan,it Serie A,18,2005,0.3,1,1,1,0,0,0,0,,0,1,0,1,0,1,1,0,Matches
2831,Cedric Zesiger,ch SUI,DF,Wolfsburg,de Bundesliga,25,1998,18.2,19,9,13,4,2,10,22,45.5,12,32,21,11,15,34,88,1,Matches
2832,Michael Zetterer,de GER,GK,Werder Bremen,de Bundesliga,28,1995,27.0,3,1,3,0,0,3,3,100.0,0,0,0,0,0,3,7,3,Matches
2833,Nathan Zeze,fr FRA,DF,Nantes,fr Ligue 1,18,2005,11.4,11,6,9,2,0,7,14,50.0,7,12,3,9,12,23,47,1,Matches
2834,Edon Zhegrova,xk KVX,FW,Lille,fr Ligue 1,24,1999,25.4,32,18,9,15,8,14,36,38.9,22,17,1,16,8,40,8,0,Matches
2835,Piotr Zieliński,pl POL,MF,Napoli,it Serie A,29,1994,21.4,23,15,6,13,4,12,24,50.0,12,12,1,11,9,32,15,0,Matches
2836,David Zima,cz CZE,DF,Torino,it Serie A,22,2000,1.0,1,1,1,0,0,0,0,,0,0,0,0,3,4,7,0,Matches
2837,Christoph Zimmermann,de GER,DF,Darmstadt 98,de Bundesliga,30,1993,13.6,33,21,26,7,0,19,39,48.7,20,21,14,7,21,54,66,1,Matches
2838,Oleksandr Zinchenko,ua UKR,DF,Arsenal,eng Premier League,26,1996,19.1,50,30,19,24,7,35,52,67.3,17,18,3,15,20,70,26,2,Matches
2839,Joshua Zirkzee,nl NED,FW,Bologna,it Serie A,22,2001,30.7,32,20,8,15,9,13,24,54.2,11,25,2,23,3,35,36,0,Matches
2840,Luck Zogbé,ci CIV,DF,Brest,fr Ligue 1,18,2005,0.1,0,0,0,0,0,0,1,0.0,1,1,1,0,1,1,0,0,Matches
2841,Simon Zoller,de GER,"FW,MF",Bochum,de Bundesliga,32,1991,0.5,0,0,0,0,0,0,0,,0,1,0,1,0,0,0,0,Matches
2842,Nadir Zortea,it ITA,DF,Frosinone,it Serie A,24,1999,14.0,21,14,8,13,0,10,22,45.5,12,13,5,8,4,25,29,1,Matches
2843,Nadir Zortea,it ITA,DF,Atalanta,it Serie A,24,1999,1.7,5,4,3,1,1,1,4,25.0,3,2,0,2,1,6,3,0,Matches
2844,Kurt Zouma,fr FRA,DF,West Ham,eng Premier League,28,1994,31.5,23,17,14,9,0,10,16,62.5,6,38,28,10,29,52,160,0,Matches
2845,Igor Zubeldia,es ESP,DF,Real Sociedad,es La Liga,26,1997,28.0,32,25,20,10,2,19,26,73.1,7,28,19,9,32,64,97,3,Matches
2846,Martín Zubimendi,es ESP,MF,Real Sociedad,es La Liga,24,1999,29.5,49,27,18,29,2,23,42,54.8,19,33,9,24,37,86,54,0,Matches
2847,Szymon Żurkowski,pl POL,MF,Empoli,it Serie A,25,1997,9.6,15,6,5,8,2,5,15,33.3,10,5,1,4,6,21,11,0,Matches
2848,Lovro Zvonarek,hr CRO,"FW,MF",Bayern Munich,de Bundesliga,18,2005,1.8,0,0,0,0,0,0,5,0.0,5,3,0,3,0,0,2,0,Matches
2849,Martin Ødegaard,no NOR,MF,Arsenal,eng Premier League,24,1998,34.3,49,17,18,21,10,17,58,29.3,41,23,1,22,15,64,5,0,Matches
2850,Milan Đurić,ba BIH,FW,Hellas Verona,it Serie A,33,1990,13.4,1,0,0,0,1,0,3,0.0,3,0,0,0,1,2,13,0,Matches
2851,Milan Đurić,ba BIH,FW,Monza,it Serie A,33,1990,14.0,5,5,0,5,0,2,4,50.0,2,6,2,4,0,5,27,0,Matches
2852,Mateusz Łęgowski,pl POL,MF,Salernitana,it Serie A,20,2003,12.7,23,12,8,12,3,11,26,42.3,15,13,2,11,7,30,16,0,Matches
